Авилов 	 Avilov
Авилова Л. Ал. 	 Avilova L. Al.
Авилова Нина 	 Avilova Nina
Авиловы 	 Avilovy
Авксентьев Н. Д. 	 Avksent'ev N. D.
Авксентьева Шура 	 Avksent'eva Shura
Ага А. И. 	 Aga A. I.
Агралл Зигурд, проф. 	 Agrall Zigurd, prof.
Адамович Г. В. 	 Adamovich G. V.
Азеф И. 	 Azef I.
Аитов В. Д., д-р 	 Aitov V. D., d-r
Аитова 	 Aitova
Айхенвальд Юл. Ис. 	 Ajhenval'd Jul. Is.
Алданов Марк (псевд. М. А. Ландау) 	 Aldanov Mark (psevd. M. A. Landau)
Алдановы 	 Aldanovy
Александр I 	 Aleksandr I
Александр II 	 Aleksandr II
Александр III 	 Aleksandr III
Александр, король серб. 	 Aleksandr, korol' serb.
Александра Федоровна, императрица 	 Aleksandra Fedorovna, imperatritsa
Алексей Михайлович, царь 	 Aleksej Mihajlovich, tsar'
Алексинский, Гр. 	 Aleksinskij, Gr.
Алексинский И. П., д-р 	 Aleksinskij I. P., d-r
Алексинская Т. И. 	 Aleksinskaja T. I.
Алексинские 	 Aleksinskie
Алексинская Н. И. 	 Aleksinskaja N. I.
Альтшулер, д-р 	 Al'tshuler, d-r
Аминад (Дон Аминадо), см. Шполянский 	 Aminad (Don Aminado), sm. Shpoljanskij
Амфитеатров А. В. 	 Amfiteatrov A. V.
Андреев Л. Н. 	 Andreev L. N.
Апухтин А. Н. 	 Apuhtin A. N.
Аргутинский П. Н. кн. 	 Argutinskij P. N. kn.
Аргутинские 	 Argutinskie
Арсеньев К. К. 	 Arsen'ev K. K.
Афонский (хор А-го) 	 Afonskij (hor A-go)
Бакст Л. 	 Bakst L.
Балавинский 	 Balavinskij
Балахович 	 Balahovich
Бальмонт К. Д. 	 Bal'mont K. D.
Бальмонт Ел. К. 	 Bal'mont El. K.
Бальмонты 	 Bal'monty
Баратов H. H., ген. 	 Baratov H. H., gen.
Барятинский В. В., кн. 	 Barjatinskij V. V., kn.
Беек Фр. 	 Beek Fr.
Белинский В. 	 Belinskij V.
Белич А. И. 	 Belich A. I.
Белобородое А. Я. 	 Beloborodoe A. Ja.
Белый Андрей (Бугаев Б. Н.) 	 Belyj Andrej (Bugaev B. N.)
Бенеш Э. 	 Benesh E.
Берберова Н. 	 Berberova N.
Бердяев H. 	 Berdjaev H.
Бернацкий, проф. 	 Bernatskij, prof.
Бернацкие 	 Bernatskie
Бетховен Л. 	 Bethoven L.
Билибин И. 	 Bilibin I.
Блок А. А. 	 Blok A. A.
Блох Г. А. 	 Bloh G. A.
Блохи 	 Blohi
Борис Влад., вел. кн. 	 Boris Vlad., vel. kn.
Боссар (изд.) 	 Bossar (izd.)
Брежнев А. Н. 	 Brezhnev A. N.
Брежневы 	 Brezhnevy
Брешко-Брешковский H. H. 	 Breshko-Breshkovskij H. H.
Брюсов Вал. Я. 	 Brjusov Val. Ja.
Будберг, бар. 	 Budberg, bar.
Буковецкий Е. И. 	 Bukovetskij E. I.
Бунаков, см. Фондаминский 	 Bunakov, sm. Fondaminskij
Бунин А. Н. (отец) 	 Bunin A. N. (otets)
Бунин Евг. А. 	 Bunin Evg. A.
Бунин Юлий А. 	 Bunin Julij A.
Бунина А. Н., ур. Цакни 	 Bunina A. N., ur. Tsakni
Бунина Л. А. (мать) 	 Bunina L. A. (mat')
Бунина Анаст. К. (Настя) 	 Bunina Anast. K. (Nastja)
Бунины (семья) 	 Buniny (sem'ja)
Бурд С. 	 Burd S.
Бурцев В. Л. 	 Burtsev V. L.
Бухарин 	 Buharin
Валери Поль 	 Valeri Pol'
Васильев, д-р 	 Vasil'ev, d-r
Вахрушевы 	 Vahrushevy
Вересаев В. В. (Смидович) 	 Veresaev V. V. (Smidovich)
Верлэн П. 	 Verlen P.
Вертинский А. 	 Vertinskij A.
Верхарн Э. 	 Verharn E.
Веселовский 	 Veselovskij
Винтерфельд 	 Vinterfel'd
Виталий, старец 	 Vitalij, starets
Вишневский Вс. 	 Vishnevskij Vs.
Вишняк М. В. 	 Vishnjak M. V.
В-и 	 V-i
Винчи Леонардо да 	 Vinchi Leonardo da
Володарский 	 Volodarskij
Вольтер 	 Vol'ter
Волынский А. П. 	 Volynskij A. P.
Врангель П. Н., ген., барон 	 Vrangel' P. N., gen., baron
Врубель С. А. 	 Vrubel' S. A.
Вульф Вирджиния 	 Vul'f Virdzhinija
Вырубов В. В. 	 Vyrubov V. V.
Высоцкая Н. Г. 	 Vysotskaja N. G.
В-ие 	 V-ie
Вышеславцев Б. П. 	 Vysheslavtsev B. P.
Вышеславцева 	 Vysheslavtseva
Гааз д-р 	 Gaaz d-r
Габрилович Л. Е. 	 Gabrilovich L. E.
Гавронская Л. С. 	 Gavronskaja L. S.
Гавронский д-р Б. О. 	 Gavronskij d-r B. O.
Гальперн, адв. 	 Gal'pern, adv.
Гамсун Кнут 	 Gamsun Knut
Гегель 	 Gegel'
Гербер (изд.) 	 Gerber (izd.)
Герцен А. 	 Gertsen A.
Герцен Н. Ал. 	 Gertsen N. Al.
Гершензон М. О. 	 Gershenzon M. O.
Гессен А. 	 Gessen A.
Гессен И. В. 	 Gessen I. V.
Гессен Н. 	 Gessen N.
Гете В. 	 Gete V.
Гиппиус 3. Н. (Мережковская) 	 Gippius 3. N. (Merezhkovskaja)
Гиппиус Татьяна Н. 	 Gippius Tat'jana N.
Гирс А. Ф. 	 Girs A. F.
Гитлер А. 	 Gitler A.
Глазунов А. 	 Glazunov A.
Гликберг А. М. см. Черный Саша 	 Glikberg A. M. sm. Chernyj Sasha
Гоголь Н. В. 	 Gogol' N. V.
Годунов Борис 	 Godunov Boris
Голобородько И. 	 Goloborod'ko I.
Голштейн А. В. 	 Golshtejn A. V.
Гольдштейн М. Л. 	 Gol'dshtejn M. L.
Гольцев В. А. 	 Gol'tsev V. A.
Гончарова Н. С. 	 Goncharova N. S.
Гораций 	 Goratsij
Горький Максим (А. М. Пешков) 	 Gor'kij Maksim (A. M. Peshkov)
Горькие 	 Gor'kie
Гофман М. Л. 	 Gofman M. L.
Гребенщиков Г. Д. 	 Grebenschikov G. D.
Гребенщиковы 	 Grebenschikovy
Григ Э. 	 Grig E.
Григорьев Ал. 	 Grigor'ev Al.
Гримм Д. Д. 	 Grimm D. D.
Грозный, см. Иоанн Грозный 	 Groznyj, sm. Ioann Groznyj
Гукасов А. О. 	 Gukasov A. O.
Гуль Р. Б. 	 Gul' R. B.
Гусаков А. Г., проф. 	 Gusakov A. G., prof.
Густав, шв. король 	 Gustav, shv. korol'
Гутман 	 Gutman
Гучков А. И. 	 Guchkov A. I.
Даль Вл. 	 Dal' Vl.
Дали 	 Dali
Данте 	 Dante
Дейч Л. Г. 	 Dejch L. G.
Демидов И. П. 	 Demidov I. P.
Демидова 	 Demidova
Деникин А. И., ген. 	 Denikin A. I., gen.
Денисов 	 Denisov
Денисова 	 Denisova
Джемс 	 Dzhems
Дзержинский Ф. 	 Dzerzhinskij F.
Диоген 	 Diogen
Дионео (Шкловский И. В.) 	 Dioneo (Shklovskij I. V.)
Дионис 	 Dionis
Дон Аминадо, см. Шполянский 	 Don Aminado, sm. Shpoljanskij
Донзель Морис 	 Donzel' Moris
Достоевский Ф. М. 	 Dostoevskij F. M.
Дроздов А. М. 	 Drozdov A. M.
Дурново П. 	 Durnovo P.
Дягилев С. П. 	 Djagilev S. P.
Дьякова 	 D'jakova
Евлогий, архиеп. 	 Evlogij, arhiep.
Елпатьевский, д-р 	 Elpat'evskij, d-r
Ельяшевич В. Б., проф. 	 El'jashevich V. B., prof.
Ельяшевич Ф. Ос-а 	 El'jashevich F. Os-a
Еремеева О. Л. 	 Eremeeva O. L.
Есенин Сергей 	 Esenin Sergej
Жид Андрэ 	 Zhid Andre
Жозеф 	 Zhozef
Зайцев Б. К. (Борис, Боря) 	 Zajtsev B. K. (Boris, Borja)
Зайцева В. А. (Верочка) 	 Zajtseva V. A. (Verochka)
Зайцевы (Зайчики) 	 Zajtsevy (Zajchiki)
Зайцева Наташа (см. Соллогуб) 	 Zajtseva Natasha (sm. Sollogub)
Зайцев К. О. 	 Zajtsev K. O.
Зайцевы 	 Zajtsevy
Замятин Е. 	 Zamjatin E.
Зенинов В. М. 	 Zeninov V. M.
Зернов В. М., д-р 	 Zernov V. M., d-r
Зилотти А. 	 Zilotti A.
Злобин Вл. А. (Володя) 	 Zlobin Vl. A. (Volodja)
Зноские 	 Znoskie
Зуров Л. Ф. (Леня, Скабарь, Питомец, Лось) 	 Zurov L. F. (Lenja, Skabar', Pitomets, Los')
Ибаньес Бласко 	 Iban'es Blasko
Иванов Вяч. Ив. 	 Ivanov Vjach. Iv.
Иванов Георгий В. 	 Ivanov Georgij V.
Иванов С. А. 	 Ivanov S. A.
Игнатьев, граф 	 Ignat'ev, graf
Иловайская О. 	 Ilovajskaja O.
Иловайский В. И., проф. 	 Ilovajskij V. I., prof.
Иловайские 	 Ilovajskie
Ильин И. А., проф. 	 Il'in I. A., prof.
Ильины 	 Il'iny
Инбер В. 	 Inber V.
Иоанн Грозный 	 Ioann Groznyj
Каган-Семенов 	 Kagan-Semenov
Кал грен А., проф. 	 Kal gren A., prof.
Каллаш М. (псевд. Курдюмов) 	 Kallash M. (psevd. Kurdjumov)
Каляев 	 Kaljaev
Кант Э. 	 Kant E.
Капитан, см. Н. Рощин 	 Kapitan, sm. N. Roschin
Карабчевский 	 Karabchevskij
Карлфельд 	 Karlfel'd
Карташев А. Вл., проф. 	 Kartashev A. Vl., prof.
Карташевы 	 Kartashevy
Карсавина Т. П. 	 Karsavina T. P.
Катаев В. 	 Kataev V.
Качалов В. И. 	 Kachalov V. I.
Кедрин 	 Kedrin
Кедровы 	 Kedrovy
Керенский А. Ф. 	 Kerenskij A. F.
Кессель И. 	 Kessel' I.
Кизеветтер А. А., проф. 	 Kizevetter A. A., prof.
Кишкин 	 Kishkin
Клодиа (портниха) 	 Klodia (portniha)
Ключевский В. О., проф. 	 Kljuchevskij V. O., prof.
Книппер (Чехова) О. Л. 	 Knipper (Chehova) O. L.
Ковалевский M. M. 	 Kovalevskij M. M.
Койранский А. А. 	 Kojranskij A. A.
Койранские 	 Kojranskie
Колчак А. В., адмирал 	 Kolchak A. V., admiral
Комиссаржевская 	 Komissarzhevskaja
Константин Константинович, вел. кн. 	 Konstantin Konstantinovich, vel. kn.
Конюс Т. С. (ур. Рахманинова) 	 Konjus T. S. (ur. Rahmaninova)
Корнилов Л. Г., ген. 	 Kornilov L. G., gen.
Корнилов Ф. Д. 	 Kornilov F. D.
Короленко В. Г. 	 Korolenko V. G.
Крандиевский 	 Krandievskij
Кречетов С. А. 	 Krechetov S. A.
Кречетовы 	 Krechetovy
Кривошеий А. В. 	 Krivosheij A. V.
Кривошеины 	 Krivosheiny
Кронштадский о. Иоанн 	 Kronshtadskij o. Ioann
Крымов В. П. 	 Krymov V. P.
Кугушева Ася 	 Kugusheva Asja
Кугушева М. А. 	 Kugusheva M. A.
Кугушевы 	 Kugushevy
Кузнецова Г. Н. (Галина, Галя) 	 Kuznetsova G. N. (Galina, Galja)
Кузьмин-Караваев Д. 	 Kuz'min-Karavaev D.
Кульман Н. К., проф. 	 Kul'man N. K., prof.
Кульман Н. И. 	 Kul'man N. I.
Кульманы 	 Kul'many
Кун Бэлла 	 Kun Bella
Кулябко-Карецкий Н. И. 	 Kuljabko-Karetskij N. I.
Куприн А. И. (папочка) 	 Kuprin A. I. (papochka)
Куприна Е. М. (Лизи) 	 Kuprina E. M. (Lizi)
Куприны 	 Kupriny
Курдюмов см. Каллаш 	 Kurdjumov sm. Kallash
Кусевицкий С. А. 	 Kusevitskij S. A.
Кусиков 	 Kusikov
Кускова Е. Д. 	 Kuskova E. D.
Кустодиев Б. М. 	 Kustodiev B. M.
Кутепов А. П., ген. 	 Kutepov A. P., gen.
Кянжунцевы 	 Kjanzhuntsevy
Лавров П. Л. 	 Lavrov P. L.
Ладыженский В. Н. 	 Ladyzhenskij V. N.
Лазаревский Б. А. 	 Lazarevskij B. A.
Ландау Гр. 	 Landau Gr.
Ландау М. А. (см. Алданов Марк) 	 Landau M. A. (sm. Aldanov Mark)
Ландау Т. М. 	 Landau T. M.
Лаоцзы 	 Laotszy
Лапинская 	 Lapinskaja
Ларионов М. Ф. 	 Larionov M. F.
Левина М. 	 Levina M.
Левины 	 Leviny
Ленин В. И. 	 Lenin V. I.
Леонтьев К. 	 Leont'ev K.
Лермонтов М. Ю. 	 Lermontov M. Ju.
Лист Ф. 	 List F.
Литовцев, см. Поляков-Литовцев С. Л. 	 Litovtsev, sm. Poljakov-Litovtsev S. L.
Лифарь С. М. 	 Lifar' S. M.
Лихошерстов 	 Lihosherstov
Ллойд Джордж Д. 	 Llojd Dzhordzh D.
Лоло (Мунштейн В. Н.) 	 Lolo (Munshtejn V. N.)
Лопатин Вл. М. 	 Lopatin Vl. M.
Лопатин Л. М. 	 Lopatin L. M.
Лопатина Ек. М. (Лопатэн) 	 Lopatina Ek. M. (Lopaten)
Лохвицкий, ген. 	 Lohvitskij, gen.
Лужские 	 Luzhskie
Луначарский А. В. 	 Lunacharskij A. V.
Лурье С. В. 	 Lur'e S. V.
Львов Г. Е., князь 	 L'vov G. E., knjaz'
Львов Лоллий И. 	 L'vov Lollij I.
Любимов, свящ. 	 Ljubimov, svjasch.
Лютер А. 	 Ljuter A.
Ляцкий Е. А. 	 Ljatskij E. A.
Маан, д-р (он же Мак) 	 Maan, d-r (on zhe Mak)
Магеровский Л. Ф. 	 Magerovskij L. F.
Макеев M. H. 	 Makeev M. H.
Маклаков В. А. 	 Maklakov V. A.
Маклакова М. 	 Maklakova M.
Маклаковы 	 Maklakovy
Маклаков Ю. Н. 	 Maklakov Ju. N.
Маковский С. К. 	 Makovskij S. K.
Малиновская 	 Malinovskaja
Малиновский 	 Malinovskij
Малявин Ф. А. 	 Maljavin F. A.
Мамонтов Савва 	 Mamontov Savva
Манн Томас 	 Mann Tomas
Мансфильд Кат. 	 Mansfil'd Kat.
Манухин И. И., д-р 	 Manuhin I. I., d-r
Манухина Т. И. 	 Manuhina T. I.
Манухины 	 Manuhiny
Маркс Карл 	 Marks Karl
Маршак А. О., д-р 	 Marshak A. O., d-r
Маяковский В. 	 Majakovskij V.
Медичи Ек. 	 Medichi Ek.
Мейнгард 	 Mejngard
Мельгунов СП., проф. 	 Mel'gunov SP., prof.
Мельников-Печерский П. И. 	 Mel'nikov-Pecherskij P. I.
Менье 	 Men'e
Мережковский Д. С. 	 Merezhkovskij D. S.
Мережковская Зин. Н. см. Гиппиус З. Н. 	 Merezhkovskaja Zin. N. sm. Gippius Z. N.
Мережковские 	 Merezhkovskie
Микоян А. 	 Mikojan A.
Милица Ник., вел. княг. 	 Militsa Nik., vel. knjag.
Миллер Е. К., ген. 	 Miller E. K., gen.
Милль Пьер 	 Mill' P'er
Милюков П. Н. 	 Miljukov P. N.
Минский (Виленкин) H. M. 	 Minskij (Vilenkin) H. M.
Минские 	 Minskie
Миронов Н. Д. 	 Mironov N. D.
Мироновы 	 Mironovy
Мирский (Святополк-Мирский) Д. П. 	 Mirskij (Svjatopolk-Mirskij) D. P.
Михайлов, д-р 	 Mihajlov, d-r
Михайлов П. А., проф. 	 Mihajlov P. A., prof.
Михайловы 	 Mihajlovy
Могилянский 	 Mogiljanskij
МоисеенкоЕ. И. 	 MoiseenkoE. I.
Могилевский 	 Mogilevskij
Мольер 	 Mol'er
Мопассан 	 Mopassan
Москвин И. М. 	 Moskvin I. M.
Мочульский К. В. 	 Mochul'skij K. V.
Муллен Камилл де 	 Mullen Kamill de
Мунейхин Мисюрь 	 Munejhin Misjur'
Муромцев Вс. Н. (Сева) 	 Muromtsev Vs. N. (Seva)
Муромцев Дм. Н. (Митя) 	 Muromtsev Dm. N. (Mitja)
Муромцев Н. (папа) 	 Muromtsev N. (papa)
Муромцев П. Н. (Павлик) 	 Muromtsev P. N. (Pavlik)
Муромцева Л. Ф. (мама) 	 Muromtseva L. F. (mama)
Муссолини 	 Mussolini
Мустангет 	 Mustanget
Набоков В. Д. 	 Nabokov V. D.
Наполеон 	 Napoleon
Нарышкины 	 Naryshkiny
Неклюдов А. В. 	 Nekljudov A. V.
Неклюдова 	 Nekljudova
Неклюдовы 	 Nekljudovy
Немирович-Данченко В. И. 	 Nemirovich-Danchenko V. I.
Нижинская 	 Nizhinskaja
Николай I 	 Nikolaj I
Николай II 	 Nikolaj II
Николай Николаевич, вел. кн. 	 Nikolaj Nikolaevich, vel. kn.
Нилус П. А. (Петр) 	 Nilus P. A. (Petr)
Нилус Б. С. 	 Nilus B. S.
Нилусы 	 Nilusy
Нобель Альфред 	 Nobel' Al'fred
Нобель Г. Л. 	 Nobel' G. L.
Нобель Марта Л. 	 Nobel' Marta L.
Нобель Э. Л. 	 Nobel' E. L.
Нобели 	 Nobeli
Новгородцев П. И., проф. 	 Novgorodtsev P. I., prof.
Новосильцев, ген. 	 Novosil'tsev, gen.
Нольде Б. Э., барон 	 Nol'de B. E., baron
Нувель В. Ф. 	 Nuvel' V. F.
Овсянико-Куликовский Д. Н. 	 Ovsjaniko-Kulikovskij D. N.
Одоевцева Ирина 	 Odoevtseva Irina
Олейников 	 Olejnikov
Олейниковы 	 Olejnikovy
Ольденбургский А. П., принц 	 Ol'denburgskij A. P., prints
Онегин (музей Онегина) 	 Onegin (muzej Onegina)
Орлов-Давыдов 	 Orlov-Davydov
Осоргин М. А. 	 Osorgin M. A.
Осоргина (Рери) 	 Osorgina (Reri)
Осоргины 	 Osorginy
Оцуп Н. А. 	 Otsup N. A.
Павловичи 	 Pavlovichi
Палеолог 	 Paleolog
Паскаль 	 Paskal'
Петр Великий 	 Petr Velikij
Петр Николаевич, вел. кн. 	 Petr Nikolaevich, vel. kn.
Петрарка 	 Petrarka
Петровская H. И. (Соколова-Кречетова) 	 Petrovskaja H. I. (Sokolova-Krechetova)
Пешков А. М. см. Горький 	 Peshkov A. M. sm. Gor'kij
Пешков Максим 	 Peshkov Maksim
Пешкова Е. П. 	 Peshkova E. P.
Пикассо Пабло 	 Pikasso Pablo
Пилкины 	 Pilkiny
Пилсудский Ю. 	 Pilsudskij Ju.
Писаревские 	 Pisarevskie
Платон 	 Platon
Плевако Ф. Н. 	 Plevako F. N.
Плевицкая Н. В. 	 Plevitskaja N. V.
Плеханов Г. В. 	 Plehanov G. V.
Плещеев 	 Plescheev
Плотин 	 Plotin
По Эдгар 	 Po Edgar
Полнер Т. И. 	 Polner T. I.
Полонский Я. Б. 	 Polonskij Ja. B.
Полонские 	 Polonskie
Поляков А. А. 	 Poljakov A. A.
Поляков-Литовцев С. Л. 	 Poljakov-Litovtsev S. L.
Потресов С. В. см. Яблоновский 	 Potresov S. V. sm. Jablonovskij
Прево Марсель 	 Prevo Marsel'
Прокопович 	 Prokopovich
Прокофьев С. С. 	 Prokof'ev S. S.
Пруст М. 	 Prust M.
Пуанкарэ Р. 	 Puankare R.
Пуарэ 	 Puare
Пушкин 	 Pushkin
Пэти Е. Ю. 	 Peti E. Ju.
Радищев А. Н. 	 Radischev A. N.
Раковский 	 Rakovskij
Распутин Гр. 	 Rasputin Gr.
Рахманинов С. В. 	 Rahmaninov S. V.
Рахманинова 	 Rahmaninova
Рахманинова см. Конюс Т. С. 	 Rahmaninova sm. Konjus T. S.
Рахманиновы 	 Rahmaninovy
Рачковский 	 Rachkovskij
Ремизов А. М. 	 Remizov A. M.
Репин Илья 	 Repin Il'ja
Рильке Райнер М. 	 Ril'ke Rajner M.
Роговский 	 Rogovskij
Роджерс 	 Rodzhers
Родэн Р. Ф. О. 	 Roden R. F. O.
Розанов В. В. 	 Rozanov V. V.
Розенберг К. 	 Rozenberg K.
Розенталь Л. М. 	 Rozental' L. M.
Роллан Ромэн 	 Rollan Romen
Ролль 	 Roll'
Романовы 	 Romanovy
Ростовцев М. И. 	 Rostovtsev M. I.
Ростовцевы 	 Rostovtsevy
Рощин Н. (Капитан) 	 Roschin N. (Kapitan)
Рощина-Инсарова Е. 	 Roschina-Insarova E.
Руднев В. В. 	 Rudnev V. V.
Рудневы 	 Rudnevy
Русов 	 Rusov
Рябушинская М. Д. 	 Rjabushinskaja M. D.
Савельев А. 	 Savel'ev A.
Савинков Б. В. 	 Savinkov B. V.
Савинкова Е. И. 	 Savinkova E. I.
Савинковы 	 Savinkovy
Сазонов И. 	 Sazonov I.
Сальери А. 	 Sal'eri A.
Самозванец (Дмитрий Отрепьев) 	 Samozvanets (Dmitrij Otrep'ev)
Самойловы 	 Samojlovy
Серов С. М., д-р 	 Serov S. M., d-r
Сирин (псевд. В. В. Набокова) 	 Sirin (psevd. V. V. Nabokova)
Скирмунт С. А. 	 Skirmunt S. A.
Скобцова Е. Ю. (мать Мария) 	 Skobtsova E. Ju. (mat' Marija)
Скоропадский П. П., ген. 	 Skoropadskij P. P., gen.
Соколов С. А. (псевд. Кречетов, см.) 	 Sokolov S. A. (psevd. Krechetov, sm.)
Солдатский 	 Soldatskij
Соллогуб Н. Б., ур. Зайцева 	 Sollogub N. B., ur. Zajtseva
Соллогубы 	 Solloguby
Соловьев С. М. 	 Solov'ev S. M.
Соловьев Влад. 	 Solov'ev Vlad.
Соломон 	 Solomon
Сорин С. 	 Sorin S.
Сосновский 	 Sosnovskij
Спасский о. Георгий 	 Spasskij o. Georgij
Спесивцева 	 Spesivtseva
Спирович 	 Spirovich
Спировичи 	 Spirovichi
Сталин 	 Stalin
Сталь м-ме де 	 Stal' m-me de
Станиславский К. С. 	 Stanislavskij K. S.
Стахович Г. Е. 	 Stahovich G. E.
Стеллецкий Д. С. 	 Stelletskij D. S.
Стендаль 	 Stendal'
Степун Марг. А. 	 Stepun Marg. A.
Степун Ф. А., проф. 	 Stepun F. A., prof.
Степун Нат. 	 Stepun Nat.
Степуны 	 Stepuny
Стравинский Игорь 	 Stravinskij Igor'
Струве А. П. 	 Struve A. P.
Струве Г. П., проф. 	 Struve G. P., prof.
Струве П. Б., проф. 	 Struve P. B., prof.
Судейкин С. 	 Sudejkin S.
Сургучев И. Д. 	 Surguchev I. D.
Тагор Рабиндранат 	 Tagor Rabindranat
Тарновский, полк. 	 Tarnovskij, polk.
Татаринов 	 Tatarinov
Телешов А. Н. 	 Teleshov A. N.
Телешов Н. Д. 	 Teleshov N. D.
Телешова Ел. А. 	 Teleshova El. A.
Телешовы 	 Teleshovy
Темирязев, кн. 	 Temirjazev, kn.
Теодорик 	 Teodorik
Тикстон П. А. 	 Tikston P. A.
Тихон патриарх 	 Tihon patriarh
Токарский 	 Tokarskij
Толстой А. К. 	 Tolstoj A. K.
Толстой А. Н. 	 Tolstoj A. N.
Толстая Н. (Наташа) 	 Tolstaja N. (Natasha)
Толстые 	 Tolstye
Толстые Ника, Фефа, Митя, Марьяна 	 Tolstye Nika, Fefa, Mitja, Mar'jana
Толстая А. Л. 	 Tolstaja A. L.
Толстой Лев 	 Tolstoj Lev
Толстая С. А. 	 Tolstaja S. A.
Топорков 	 Toporkov
Третьяковы 	 Tret'jakovy
Троцкий И. 	 Trotskij I.
Троцкий Лев 	 Trotskij Lev
Тургенев И. С. 	 Turgenev I. S.
Тыркова-Вильямс А. В. 	 Tyrkova-Vil'jams A. V.
Тютчев Ф. 	 Tjutchev F.
Тютчевы А. Ф. и Китти 	 Tjutchevy A. F. i Kitti
Тэффи Н. А. (Лохвицкая) 	 Teffi N. A. (Lohvitskaja)
Ундсет Зигрид 	 Undset Zigrid
Унковский, д-р 	 Unkovskij, d-r
Урицкий М. 	 Uritskij M.
Уэльс Герберт 	 Uel's Gerbert
Фарер Клод 	 Farer Klod
Фареры 	 Farery
Федин К. 	 Fedin K.
Федоров А. М. 	 Fedorov A. M.
Федоров Н. 	 Fedorov N.
Федотов Г. П., проф. 	 Fedotov G. P., prof.
Фет А. 	 Fet A.
Филоненко M. M. 	 Filonenko M. M.
Философов Д. В. 	 Filosofov D. V.
Флобер Гюстав 	 Flober Gjustav
Фондаминский И. И. (Бунаков-Фондаминский, Илис, Илюша) 	 Fondaminskij I. I. (Bunakov-Fondaminskij, Ilis, Iljusha)
Фондаминская А. О. 	 Fondaminskaja A. O.
Фондаминские 	 Fondaminskie
Франс Анатоль 	 Frans Anatol'
Франциск I 	 Frantsisk I
Фрейд Зигмунд 	 Frejd Zigmund
Харитоненко 	 Haritonenko
Ховен, барон 	 Hoven, baron
Ходасевич В. Д. 	 Hodasevich V. D.
Ходасевичи 	 Hodasevichi
Хомяков А. С. 	 Homjakov A. S.
Цакни А. Н., см. Бунина 	 Tsakni A. N., sm. Bunina
Цетлин А. В. 	 Tsetlin A. V.
Цетлин М. О. 	 Tsetlin M. O.
Цетлина М. С. 	 Tsetlina M. S.
Цетлины 	 Tsetliny
Цетлин О. С. 	 Tsetlin O. S.
Цветаева Марина 	 Tsvetaeva Marina
Цвибак Я. (псевд. -- Андрей Седых) 	 Tsvibak Ja. (psevd. -- Andrej Sedyh)
Чайковский Н. В. 	 Chajkovskij N. V.
Чайковская В. Н. 	 Chajkovskaja V. N.
Чайковский М. 	 Chajkovskij M.
Чернов В. M. 	 Chernov V. M.
Черный Саша (Гликберг А. М.) 	 Chernyj Sasha (Glikberg A. M.)
Чехов А. П. 	 Chehov A. P.
Чехов И. П. 	 Chehov I. P.
Чехов Мих. 	 Chehov Mih.
Чехова М. П. 	 Chehova M. P.
Чириков Е. 	 Chirikov E.
Шаляпин Федор 	 Shaljapin Fedor
Шаляпина М. В. 	 Shaljapina M. V.
Шаляпина Стелла 	 Shaljapina Stella
Шапен м-лле 	 Shapen m-lle
Шассен 	 Shassen
Шаховская З. А., кн. 	 Shahovskaja Z. A., kn.
Шаховской Д. А., кн. (арх. Иоанн Сан-Францисский) 	 Shahovskoj D. A., kn. (arh. Ioann San-Frantsisskij)
Ш-ие 	 Sh-ie
Шекспир 	 Shekspir
Шеллинг 	 Shelling
Шестов Лев 	 Shestov Lev
Шестовы 	 Shestovy
Шиман, д-р 	 Shiman, d-r
Шишкина-Афанасьева 	 Shishkina-Afanas'eva
Шлецер Б. Ф. 	 Shletser B. F.
Шмелев И. С. 	 Shmelev I. S.
Шмелева О. А. 	 Shmeleva O. A.
Шмелевы 	 Shmelevy
Шполянский А. П. (Дон-Аминадо, Аминад) 	 Shpoljanskij A. P. (Don-Aminado, Aminad)
Штерн 	 Shtern
Шульгин В. В. 	 Shul'gin V. V.
Щеголев М. 	 Schegolev M.
Щепкина-Куперник Т. Л. 	 Schepkina-Kupernik T. L.
Щербатов, кн. 	 Scherbatov, kn.
Эмилия Вас. 	 Emilija Vas.
Эренбург Илья 	 Erenburg Il'ja
Эристова, кн. 	 Eristova, kn.
Эртель А. И. 	 Ertel' A. I.
Эррио Э. 	 Errio E.
Юрьев 	 Jur'ev
Юсупов Ф., кн. 	 Jusupov F., kn.
Юшкевич П. 	 Jushkevich P.
Юшкевич С. С. 	 Jushkevich S. S.
Яблоновский А. 	 Jablonovskij A.
Яблоновский С. В. (Потресов) 	 Jablonovskij S. V. (Potresov)
Яблоновские 	 Jablonovskie
Якобсон Е. 	 Jakobson E.
Якунчикова 	 Jakunchikova
