Из 	 из
записей 	 запись
Веры 	 вера
Николаевны 	 николай
1 	 1
янв 	 янв
1928/19 	 1928/19
дек 	 дек
1927 	 1927
Францию 	 франция
с 	 с
Новым 	 новый
Годом 	 год
А 	 а
я 	 я
еще 	 ещё
не 	 не
чувствую 	 чувствовать
что 	 что
Новый 	 новый
год 	 год
идет 	 идти
хотя 	 хотя
уже 	 уже
8 	 8
лет 	 год
встречаю 	 встречать
его 	 он
во 	 в
Франции 	 франция
и 	 и
все 	 весь
привыкла 	 привыкнуть
 	 
2 	 2
января 	 январь
В 	 в
Днях 	 день
напечатан 	 напечатать
рассказ 	 рассказ
Г 	 год
Н 	 наш
Кузнецовой 	 кузнецов
-- 	 --
М 	 метр
Статья 	 статья
Макеева 	 макеев
о 	 о
Совр 	 совр
Зап. 	 зап.
Восхищается 	 восхищаться
Божьим 	 божий
Древом1 	 древом1
но 	 но
говорит 	 говорить
эта 	 этот
жизнь 	 жизнь
канула 	 кануть
в 	 в
вечность 	 вечность
Ян 	 ян
сказал 	 сказать
Я 	 я
пишу 	 писать
душе 	 душа
русского 	 русский
человека 	 человек
при 	 при
чем 	 чем
здесь 	 здесь
старое 	 старое
новое 	 новое
Вероятно 	 вероятно
теперь 	 теперь
какой-нибудь 	 какой-нибудь
Яков 	 яков
Еф 	 еф
трясет 	 трясти
портками 	 портки
теми 	 тот
же 	 же
присказками 	 присказка
они 	 они
это 	 это
картины 	 картина
старой 	 старый
жизни 	 жизнь
да 	 да
этом 	 это
дело 	 дело
сегодня 	 сегодня
память 	 память
мамы 	 мама
Утром 	 утром
молилась 	 молиться
Грустно 	 грустно
могу 	 мочь
отслужить 	 отслужить
панихиды 	 панихида
Утешаюсь 	 утешаться
вероятно 	 вероятно
отслужат 	 отслужить
Москве 	 москва
конспекта 	 конспект
Ивана 	 иван
Алексеевича 	 алексей
написанного 	 написать
почерком 	 почерк
на 	 на
основе 	 основа
уничтоженных 	 уничтожить
9 	 9
нов 	 новый
ст 	 ст
дальше 	 далёкий
по 	 по
н 	 наш
На 	 на
пути 	 путь
Cannes 	 cannes
слезли 	 слезть
доезжая 	 доезжать
пошли 	 послать
рощам 	 роща
мимоз 	 мимоза
Солнечн 	 солнечн
предвечернее 	 предвечерний
время 	 время
24 	 24
Кузнецова 	 кузнецов
начала 	 начало
переписывать 	 переписывать
вторую 	 два
книгу 	 книга
Жизни 	 жизнь
Арсеньева 	 арсеньев
27 	 27
Кончила 	 кончить
переписку 	 переписка
31 	 31
Напечатан 	 напечатать
Кунак 	 кунак
1.2 	 1.2
Весенний 	 весенний
день 	 день
Нарвала 	 нарвал
саду 	 сад
принесла 	 принести
мне 	 я
белых 	 белых
цветов 	 цветок
запахом 	 запах
нарциссов 	 нарцисс
4.2 	 4.2
Голые 	 голый
деревья 	 дерево
фоне 	 фон
облаков 	 облако
лунную 	 лунный
ночь 	 ночь
Облака 	 облако
кажутся 	 казаться
особенно 	 особенно
белыми 	 белый
7.2 	 7.2
При 	 при
луне 	 луна
Ниццкой 	 ниццкий
дороге 	 дорога
Кипарисы 	 кипарис
созвездие 	 созвездие
Ориона 	 орион
Кончил 	 кончить
кн 	 кн
Ж 	 ж
А. 	 а.
18.2 	 18.2
Отъезд 	 отъезд
Париж 	 париж
19.2 	 19.2
Hotel 	 hotel
Gavarni 	 gavarni
номера 	 номер
16 	 16
14 	 14
21 	 21
Завтрак 	 завтрак
у 	 у
Ага 	 ага
(в 	 (в
ресторанчике 	 ресторанчик
лавке 	 лавка
rue 	 rue
de 	 de
la 	 la
Pompe) 	 pompe)
20 	 20
С 	 с
Зайцевым 	 зайцев
Chez 	 chez
Francis 	 francis
22.2 	 22.2
Алдановым 	 алданов
23.2 	 23.2
Обед 	 обед
чай 	 чаять
Цетлиных 	 цетлин
Вера 	 вера
Николаевна 	 николай
записывает 	 записывать
23 	 23
февраля 	 февраль
1928 	 1928
г 	 год
Вчера 	 вчера
видели 	 видеть
Алданова 	 алданов
он 	 он
очень 	 очень
изменился 	 измениться
пополнел 	 пополнеть
стал 	 стать
каким-то 	 какой-то
солидным 	 солидный
такой 	 такой
милый 	 милый
деликатный 	 деликатный
заботливый 	 заботливый
Это 	 это
боится 	 бояться
моих 	 мой
дневников 	 дневник
жаловался 	 жаловаться
Цвибаку2 	 цвибаку2
Обедали 	 обедать
ушла 	 уйти
играть 	 играть
поккер 	 поккер
а 	 а
мы 	 мы
Ос 	 ос
лекцию 	 лекция
Адамовича 	 адам
которая 	 который
состоялась 	 состояться
виду 	 вид
того 	 тот
пришло 	 пришлый
4 	 4
вместе 	 вместе
лектором 	 лектор
горя 	 горе
полосатый 	 полосатый
бар 	 бар
Много 	 много
говорили 	 говорить
литературе 	 литература
Залили 	 залить
Берберовой3 	 берберовой3
за 	 за
шкуру 	 шкура
покончила 	 покончить
самоубийством 	 самоубийство
Нина 	 нина
Петровская4 	 петровская4
Верочка 	 верочка
Зайцева 	 зайцев
рассказывала 	 рассказывать
она 	 она
пила 	 пила
прибегала 	 прибегать
к 	 к
наркотикам 	 наркотик
45 	 45
дней 	 день
назад 	 назад
умерла 	 умереть
ее 	 она
сестра 	 сестра
тыкала 	 тыкать
нее 	 нея
булавки 	 булавка
затем 	 затем
колола 	 колоть
себя 	 себя
чтобы 	 чтобы
заразиться 	 заразиться
трупным 	 трупный
ядом 	 яд
Но 	 но
яд 	 яд
брал 	 брать
Жутко 	 жутко
представить 	 представить
было 	 быть
Жаль 	 жаль
знаю 	 знать
мало 	 мало
Почему-то 	 почему-то
вспоминается 	 вспоминаться
какая-то 	 какой-то
выставка 	 выставка
Строган[овском 	 строган[овский
училище 	 училище
пустые 	 пустой
залы 	 зала
одной 	 один
углу 	 угол
безжизненная 	 безжизненный
фигура 	 фигура
Брюсова5 	 брюсова5
застегнутом 	 застегнуть
сюртуке 	 сюртук
мохнатая 	 мохнатый
черная 	 чёрный
голова 	 голова
Нины 	 нина
маленьком 	 маленький
туловище 	 туловище
26 	 26
ф 	 ф
Похороны 	 похороны
расстроили 	 расстроить
больше 	 большой
ожидала 	 ожидать
Народу 	 народ
немного 	 немного
Больше 	 большой
женщины 	 женщина
Мужчин 	 мужчина
только 	 только
четверо 	 четверо
Боря 	 боря
Б 	 б
К 	 к
Зайцев 	 зайцев
Ходасевич 	 ходасевич
Соколов 	 соколов
нотариус 	 нотариус
др 	 др
Унковский 	 унковский
Гроб 	 гроб
простой 	 простой
досчатый 	 досчатый
церкви 	 церковь
покрыт 	 покрыть
был 	 быть
черным 	 чёрный
сукном 	 сукно
серебряными 	 серебряный
галунами 	 галун
И 	 и
от 	 от
этой 	 этот
простоты 	 простота
отсутствия 	 отсутствие
обычной 	 обычный
похоронах 	 похороны
пышности 	 пышность
жутко 	 жутко
Перебрались 	 перебраться
Four 	 four
Комнатка 	 комнатка
маленькая 	 маленький
есть 	 есть
У 	 у
Яна 	 ян
просторно 	 просторно
Галины 	 галина
солнечно 	 солнечно
февр 	 фёвр
Вот 	 вот
Великий 	 великий
Пост 	 пост
были 	 быть
типографии 	 типография
отвезли 	 отвезти
часть 	 часть
Читал 	 читать
Цетлин 	 цетлина
ему 	 он
понравилось 	 понравиться
Видела 	 видеть
как 	 как
делают 	 делать
набор 	 набор
вроде 	 вроде
пишущей 	 пишущий
машинке 	 машинка
выскакивают 	 выскакивать
свинцовые 	 свинцовый
плиточки 	 плиточка
Приехала 	 приехать
1/2 	 1/2
ч 	 число
церковь 	 церковь
Пила 	 пила
кофе 	 кофе
Служил 	 служилый
Владыка 	 владыка
Он 	 он
похудел 	 похуделый
лицо 	 лицо
стало 	 стать
благороднее 	 благородный
хорошо 	 хорошо
читает 	 читать
него 	 он
необыкновенно 	 необыкновенно
приятный 	 приятный
голос 	 голос
Обедала 	 обедать
ресторане 	 ресторан
Не 	 не
ела 	 есть
мяса 	 мясо
Решила 	 решить
так 	 так
поститься 	 поститься
всю 	 весь
неделю 	 неделя
Потом 	 потом
Зеленую 	 зелёный
Лампу 	 лампа
Под 	 под
зеленой 	 зелёный
лампой 	 лампа
рассуждали 	 рассуждать
насколько 	 насколько
Евангелия 	 евангелия
святы 	 святой
после 	 после
неприятно 	 неприятно
Дм 	 дм
болен 	 больной
Зин 	 зина
Ник 	 ник
была 	 быть
любезна 	 любезный
оживлена 	 оживить
мила 	 мила
когда 	 когда
сидела 	 сидеть
столом 	 стол
то 	 то
как-то 	 как-то
съежилась 	 съёжиться
жалко 	 жалко
ушли 	 уйти
Левиными 	 левин
Тэффи 	 тэффи
Ходасевичами 	 ходасевич
Берберовой 	 берберов
Жизнь 	 жизнь
понравилась 	 понравиться
нас 	 мы
Ив 	 ива
Ал 	 ала
разный 	 разный
подход 	 подход
28 	 28
Ефимоны 	 ефимона
поехала 	 поехать
Серг 	 серг
Подворье 	 подворье
дворе 	 двор
психопатка 	 психопатка
Эристова 	 эристовый
влюбленная 	 влюбить
Владыку 	 владыка
уговаривала 	 уговаривать
меня 	 я
исповедоваться 	 исповедоваться
Владыки 	 владыка
Иоанн 	 иоанн
Кронштадтский 	 кронштадтский
никогда 	 никогда
любил 	 любить
плотской 	 плотский
любовью 	 любовь
молчала 	 молчать
зная 	 знать
ответить 	 ответить
счастью 	 счастие
прошел 	 пройти
мимо 	 мимо
Карташев 	 карташева
извинилась 	 извиниться
пошла 	 пошлый
ним 	 он
Студенты 	 студент
черных 	 чёрный
подрясниках 	 подрясник
Полутьма 	 полутьма
пустота 	 пустота
мягкий 	 мягкий
Евлогия 	 евлогий
действовали 	 действовать
душу 	 душить
После 	 после
службы 	 служба
зашли 	 заслать
Каллаш 	 каллаша
кабачок 	 кабачок
дневниковых 	 дневниковый
записях 	 запись
перерыв 	 перерыв
до 	 до
мая 	 май
Делаю 	 делать
выписки 	 выписка
из 	 из
Бунина 	 бунин
10.3 	 10.3
Зеленая 	 зелёный
Лампа 	 лампа
11.3 	 11.3
Латинском 	 латинский
квартале 	 квартал
12.3 	 12.3
Куприна 	 куприн
14.3 	 14.3
Ужин 	 ужин
еврейском 	 еврейский
15 	 15
3 	 3
Бал 	 бал
писателей 	 писатель
17.3 	 17.3
Юбилей 	 юбилей
Барятинского 	 барятинский
Москва 	 москва
18.3 	 18.3
Чешск 	 чешск
ресторан 	 ресторан
19.3 	 19.3
Евр[ейский 	 евр[ейский
синема 	 синемой
22.3 	 22.3
Викинг 	 викинг
Зайцевых 	 зайцев
25.3 	 25.3
Чай 	 чаять
Вечер 	 вечер
Юшкевича 	 юшк
29 	 29
Прюнье 	 прюнья
1.4 	 1.4
Михайловых 	 михайлов
ними 	 они
5.4 	 5.4
Парижа 	 париж
5 	 5
вечера 	 вечер
остановка 	 остановка
Дижоне 	 дижон
отель 	 отель
La 	 la
Cloche 	 cloche
6.4 	 6.4
час 	 час
дня 	 день
Дижона 	 дижон
Пересадка 	 пересадка
Лионе 	 лион
Гренобль 	 гренобль
Гр 	 гр
Ночевка 	 ночёвка
там 	 там
7.4 	 7.4
полдень 	 полдень
Гренобля 	 гренобль
Digne-Nice 	 digne-nice
Auban 	 auban
6 	 6
пересадка 	 пересадка
Digne 	 digne
Ночь 	 ночь
Легли 	 лечь
Встали 	 встать
8.4 	 8.4
утра 	 утро
Ментоне 	 ментоня
du 	 du
Parc 	 parc
13.4 	 13.4
Ходили 	 ходить
вынос 	 вынос
Плащаницы 	 плащаница
Наша 	 наш
Страстная 	 страстный
дневника 	 дневник
1/14 	 1/14
Давно 	 давно
писала 	 писать
по-настоящему 	 по-настоящему
дневник 	 дневник
делать 	 делать
сравнительно 	 сравнительно
спокойна 	 спокойный
Внутренний 	 внутренний
писать 	 писать
трудно 	 трудно
стыдно 	 стыдно
Легче 	 лёгкий
приятнее 	 приятный
описывать 	 описывать
внешнюю 	 внешний
заносить 	 заносить
разные 	 разный
события 	 событие
встречи 	 встреча
Грассе 	 грасс
Все 	 весь
устроилось 	 устроиться
жаждем 	 жаждать
начать 	 начать
работать 	 работать
Мы 	 мы
устали 	 устать
кочевой 	 кочевой
клонит 	 клонить
сон 	 сон
Галину 	 галина
мил 	 мила
нежен 	 нежный
весел 	 весёлый
завтра 	 завтра
сядет 	 сесть
заниматься 	 заниматься
придет 	 прийти
книжка 	 книжка
примется 	 приняться
значит 	 значит
сейчас 	 сейчас
буду 	 быть
Может 	 мочь
быть 	 быть
месяц 	 месяц
промучаюсь 	 промучаться
нужно 	 нужно
обломать 	 обломать
выбрать 	 выбрать
просеять 	 просеять
Дождь 	 дождь
грязь 	 грязь
обеда 	 обед
Яном 	 ян
город 	 город
вдруг 	 вдруг
Марк 	 марк
Александрович 	 александр
Алданов 	 алдан
Очень 	 очень
обрадовались 	 обрадоваться
За 	 за
чаем 	 чаемый
спорили 	 спорить
Ил 	 ил
Ис 	 иса
Фондаминский 	 фондаминский
доказывал 	 доказывать
победить 	 победить
большевиков 	 большевик
можно 	 можно
лишь 	 лишь
духовной 	 духовный
силой 	 силой
считает 	 считать
большевизм 	 большевизм
держится 	 держаться
чека 	 чек
может 	 мочь
свергнут 	 свергнуть
двумя 	 два
путями 	 путь
или 	 или
дворцовым 	 дворцовый
переворотом 	 переворот
войной 	 война
находит 	 находить
революция 	 революция
произошла 	 произойти
потому 	 потому
война 	 война
избежать 	 избежать
революцию 	 революция
бы 	 бы
том 	 тот
случае 	 случай
если 	 если
дарована 	 даровать
конституция 	 конституция
Александром 	 александр
II 	 ii
согласился 	 согласиться
равно 	 равно
удовольствовались 	 удовольствоваться
дал 	 дать
Александр 	 александр
I 	 i
тогда 	 тогда
иное 	 иной
Ведь 	 ведь
Радищевым6 	 радищевым6
началось 	 начаться
неприятие 	 неприятие
вернее 	 верный
критика 	 критика
сожалению 	 сожаление
своей 	 свой
ненужной 	 ненужный
щепетильности 	 щепетильность
торопиться 	 торопиться
автобус 	 автобус
повели 	 повелеть
верхом 	 верхом
природу 	 природа
словам 	 слово
чеховский 	 чеховский
кучер 	 кучер
смотрит 	 смотреть
свысока 	 свысока
18 	 18
Сегодня 	 сегодня
юбилей 	 юбилей
Яблоновского 	 яблоновский
спор 	 спорый
ли 	 ли
устраивать 	 устраивать
подобные 	 подобный
юбилеи 	 юбилей
возмущен 	 возмутить
Чин 	 чин
нарушен 	 нарушить
Глупо 	 глупо
конечно 	 конечно
печатается 	 печататься
председ 	 председой
ак 	 ак
нахожу 	 находить
всякий 	 всякий
человек 	 человек
справлять 	 справлять
свой 	 свой
никакого 	 никакой
чина 	 чин
нарушено 	 нарушить
27/14 	 27/14
Сейчас 	 сейчас
Опять 	 опять
разговор 	 разговор
Степуне 	 степуна
Илис 	 илиса
Читаю 	 читать
Как 	 как
почитали 	 почитать
гораздо 	 гораздо
бледнее 	 бледный
Степуна 	 степуна
горжусь 	 гордиться
тем 	 тем
открыл 	 открыть
познакомились 	 познакомиться
18-ом 	 18-ом
году 	 год
почти 	 почти
никто 	 никто
знал 	 знать
приехал 	 приехать
сюда 	 сюда
сразу 	 сразу
схватился 	 схватиться
боялись 	 бояться
редакции 	 редакция
Говорили 	 говорить
кто 	 кто
знает 	 знать
монархист 	 монархист
другой 	 другой
убедить 	 убедить
искать 	 искать
людей 	 человек
понимают 	 понимать
составляется 	 составляться
всякое 	 всякий
общественное 	 общественный
течение 	 течение
Напр 	 например
славянофильское 	 славянофильский
Хомяков 	 хомяк
обосновал 	 обосновать
настроение 	 настроение
группы 	 группа
мотор 	 мотор
Завидую 	 завидовать
вам 	 вы
вы 	 вы
знаете 	 знаете
данный 	 данный
момент 	 момент
Абсолютной 	 абсолютный
истины 	 истина
нет 	 нет
история 	 история
делается 	 делаться
людьми 	 человек
которые 	 который
знают 	 знать
истину 	 истина
Да 	 да
правда 	 правда
кажется 	 кажется
правильный 	 правильный
путь 	 путь
духовно-национально-социалистический 	 духовно-национально-социалистический
думаю 	 думать
Илиса 	 илиса
социализм 	 социализм
тоже 	 тоже
первом 	 первое
месте 	 место
верно 	 верно
чувствует 	 чувствовать
упускает 	 упускать
чего 	 что
11 	 11
июня 	 июнь
крутится 	 крутиться
никак 	 никак
усядется 	 усесться
вот-вот 	 вот-вот
погрузится 	 погрузиться
весь 	 весь
убирался 	 убираться
конспекте 	 конспект
значится 	 значиться
Начал 	 начать
третью 	 три
Приехал 	 приехать
6/7 	 6/7
июля 	 июль
спится 	 спаться
Третий 	 три
Равнодушие 	 равнодушие
убивает 	 убивать
претензии 	 претензия
нельзя 	 нельзя
сам 	 сам
смятении 	 смятение
ездит 	 ездить
купаться 	 купаться
устает 	 уставать
плохо 	 плохо
спит 	 спать
волнуется 	 волноваться
Ждет 	 ждать
нетерпением 	 нетерпение
Рощина 	 рощин
Ему 	 он
приедет 	 приехать
наладится 	 наладиться
грех 	 грех
обманул 	 обмануть
спросил 	 спросить
Берберову 	 берберов
Ну 	 ну
мэтр 	 мэтр
совершенно 	 совершенно
серьезно 	 серьёзно
ответила 	 ответить
Мэтр 	 мэтр
т 	 том
д. 	 д.
16/17 	 16/17
третий 	 три
опять 	 опять
сплю 	 спать
З 	 з
Гиппиус 	 гиппиус
deux 	 deux
ней 	 она
недолго 	 недолго
никаких 	 никакой
неприятных 	 неприятный
сплетен 	 сплетня
слыхала 	 слыхать
Борис 	 борис
дважды 	 дважды
оборвал 	 оборвать
умеет 	 уметь
взволновало 	 взволновать
августа 	 август
Уехал 	 уехать
Немного 	 немного
грустно 	 грустно
Зайцеве 	 зайцев
светлость 	 светлость
понимание 	 понимание
чего-то 	 чего-то
нужного 	 нужный
чувство 	 чувство
правильности 	 правильность
своего 	 свой
великое 	 великое
счастье 	 счастие
Религиозность 	 религиозность
опора 	 опора
защита 	 защита
некая 	 некий
собственной 	 собственный
плоти 	 плоть
дома 	 дом
Конечно 	 конечно
наш 	 наш
Монастырь 	 монастырь
муз 	 муза
подходит 	 подходить
устав 	 устать
удовольствия 	 удовольствие
образ 	 образ
возможность 	 возможность
спокойно 	 спокойно
полная 	 полный
душевная 	 душевный
свобода 	 свобода
Прочла 	 прочесть
Афон 	 афон
книге 	 книга
прочла 	 прочесть
нем 	 немой
рецензию 	 рецензия
оценил 	 оценить
эту 	 этот
редкую 	 редкий
беспокоит 	 беспокоить
тих 	 тихий
кроток 	 кроткий
подавлен 	 подавить
Устал 	 устать
сердце 	 сердце
отчего 	 отчего
страдает 	 страдать
всегда 	 всегда
хуже 	 худой
бывало 	 бывать
Денег 	 деньга
осталось 	 остаться
совсем 	 совсем
донышке 	 донышко
Если 	 если
пришлют 	 прислать
чехи 	 чех
Ездили 	 ездить
Торан 	 торан
Мережковским 	 мережковский
Они 	 они
живут 	 жить
замке 	 замок
существующем 	 существующий
1525 	 1525
года 	 год
Комнаты 	 комната
толстыми 	 толстой
стенами 	 стен
амбразуры 	 амбразура
окон 	 окно
величиной 	 величина
комнату 	 комната
новых 	 новый
домах 	 дом
Воздух 	 воздух
живительный 	 живительный
прямо 	 прямо
отдохнули 	 отдохнуть
жары 	 жара
Встал 	 встать
лег 	 лечь
спать 	 спать
оставил 	 оставить
несколько 	 несколько
начал 	 начать
Толстом 	 толстой
для 	 для
Посл 	 послый
Н[овостей] 	 н[овостей]
сентября 	 сентябрь
днях 	 день
Белич 	 белич
Первое 	 первое
впечатление 	 впечатление
русский 	 русский
молодой 	 молодая
профессор 	 профессор
приглядевшись 	 приглядеться
видишь 	 видеть
постарше 	 старший
главное 	 главный
энергия 	 энергия
темперамент 	 темперамент
русские 	 русский
бывает 	 бывать
такая 	 такой
русских 	 русский
редко 	 редко
профессоров 	 профессор
скорее 	 скорее
инженеров 	 инженер
Русских 	 русский
Главная 	 главный
забота 	 забота
интерес 	 интерес
журнал 	 журнал
книгоиздательство 	 книгоиздательство
Съезд7 	 съезд7
интересует 	 интересовать
будет 	 быть
открывать 	 открывать
долго 	 долго
подробно 	 подробно
рассказывал 	 рассказывать
сербы 	 серб
сделали 	 сделать
1) 	 1)
дали 	 дать
умереть 	 умереть
голоду 	 голод
2) 	 2)
поставили 	 поставить
ноги 	 нога
3) 	 3)
открыли 	 открыть
школы 	 школа
хотят 	 хотеть
основать 	 основать
устроить 	 устроить
Деньги 	 деньга
хочет 	 хотеть
самым 	 самый
лучшим 	 хороший
интересным 	 интересный
Наметил 	 наметить
редакторов 	 редактор
Мережковского 	 мережковский
Струве 	 струве
который 	 который
жить 	 жить
Белграде 	 белград
фактически 	 фактически
технически 	 технически
руководить 	 руководить
журналом 	 журнал
отказался 	 отказаться
редакторства 	 редакторство
некогда 	 некогда
мнению 	 мнение
втроем 	 втроём
невозможно 	 невозможно
взгляды 	 взгляд
литературные 	 литературный
диаметрально 	 диаметрально
противоположные 	 противоположный
Уж 	 уж
лучше 	 хороший
пусть 	 пусть
редактором 	 редактор
один 	 один
обсуждался 	 обсуждаться
вопрос 	 вопрос
пойдут 	 пойти
писатели 	 писатель
думает 	 думать
политики 	 политика
статьи 	 статья
будут 	 быть
научно-культурного 	 научно-культурный
типа 	 тип
Сербии 	 сербия
два 	 два
течения 	 течение
одни 	 один
желают 	 желать
ассимилировались 	 ассимилироваться
другие 	 другой
наоборот 	 наоборот
остались 	 остаться
русскими 	 русский
друзьями 	 друг
сербов 	 серб
По-видимому 	 по-видимому
берет 	 брать
верх 	 верх
стихи 	 стих
Ходасевича 	 ходасевич
спрашивал 	 спрашивать
субсидию 	 субсидия
Оказывается 	 оказываться
субсидии 	 субсидия
зависят 	 зависеть
Державной 	 державный
комиссии 	 комиссия
где 	 где
председательствует 	 председательствовать
Стихи 	 стих
понравились 	 понравиться
двойственность 	 двойственность
Виделись 	 видеться
Тикстоном 	 тикстон
Впечатление 	 впечатление
им 	 имя
скучно 	 скучно
друг 	 друг
другом 	 друг
связь 	 связь
их 	 они
крепкая 	 крепкий
Свели 	 свести
Беличем 	 беликать
осталась 	 остаться
недовольна 	 недовольный
Белград 	 белград
едут 	 ехать
Возмущены 	 возмутить
редактор 	 редактор
заявляет 	 заявлять
напишу 	 написать
статью 	 статья
против 	 против
самодержавия 	 самодержавие
вот 	 вот
уйдет 	 уйти
Значит 	 значит
ясно 	 ясно
Мережковские 	 мережковский
вырвать 	 вырвать
воображаемую 	 воображать
власть 	 власть
удастся 	 удаться
стараться 	 стараться
думают 	 думать
руках 	 рука
занят 	 занятый
Арсеньевым 	 арсеньев
связан 	 связать
Записками 	 записка
опасен 	 опасный
вряд 	 вряд
станет 	 стать
принимать 	 принимать
близкое 	 близкий
участие 	 участие
Куприн 	 куприн
рамоли 	 рамоли
Шмелев 	 шмелев
Словом 	 слово
мерещится 	 мерещиться
этого 	 это
журнала 	 журнал
сделать 	 сделать
дом 	 дом
Серов 	 серов
нашел 	 найти
ослаблено 	 ослабить
раздражительность 	 раздражительность
печени 	 печень
Спрашивал 	 спрашивать
заботит 	 заботить
заживающая 	 заживать
рана 	 рана
гнетет 	 гнести
мысль 	 мысль
работе 	 работа
Совет 	 совет
постараться 	 постараться
забыть 	 забыть
19 	 19
сент 	 сента
ума 	 ум
сошел 	 сойти
насчет 	 насчёт
сердца 	 сердце
нервничает 	 нервничать
днем 	 днём
ест 	 есть
Был 	 быть
Серова 	 серов
Маану 	 маана
Боюсь 	 бояться
Маан 	 маан
успокоит 	 успокоить
нужен 	 нужный
доктор 	 доктор
Альтшулера 	 альтшулер
Сербию 	 сербия
Им 	 имя
прислали 	 прислать
10000 	 10000
фр 	 фр
будто 	 будто
пьесу 	 пьеса
сшила 	 сшить
слава 	 слава
Богу 	 бог
черное 	 чёрный
платье 	 платье
возбужден 	 возбудить
попросил 	 попросить
ту 	 тот
об 	 о
Яне 	 ян
большом 	 большой
писателе 	 писатель
большой 	 большой
личности 	 личность
издевалась 	 издеваться
над 	 над
критиками 	 критик
называют 	 называть
описателем 	 описатель
О 	 о
себе 	 себя
доверчив 	 доверчивый
верил 	 верить
ужасно 	 ужасно
поступили 	 поступить
окт 	 окт
Письмо 	 письмо
Мережк[овского 	 мережк[овский
Дорогой 	 дорогой
Сергей 	 сергей
Константинович8 	 константинович8
посылаю 	 посылать
Вам 	 вы
большую 	 большой
газету 	 газета
моим 	 мой
интервью 	 интервью
прошу 	 просить
Вас 	 вы
велите 	 велита
перевести 	 перевести
напечатайте 	 напечатать
Возрождении 	 возрождение
Интервью 	 интервью
чрезвычайно 	 чрезвычайно
важное 	 важный
благодаря 	 благодаря
многим 	 многий
обстоятельствам 	 обстоятельство
между 	 между
прочим 	 прочить
исключительно 	 исключительно
любезному 	 любезный
приему 	 приём
короля 	 король
Александра 	 александр
обеде 	 обед
сидел 	 сидеть
рядом 	 ряд
королевой 	 королева
королем 	 король
беседа 	 беседа
важна 	 важный
иметь 	 иметь
последствия 	 последствие
Ах 	 ах
забыл 	 забыть
получил 	 получить
орден 	 орден
Св 	 св
Саввы 	 савва
первой 	 один
степени 	 степень
высший 	 высокий
Югославии 	 югославия
имеет 	 иметь
большое 	 большой
значение 	 значение
Савву 	 савва
второй 	 два
Ленты 	 лента
звезды 	 звезда
рескрипты 	 рескрипт
Славяне 	 славянин
восторге 	 восторг
умилении 	 умиление
Встречали 	 встречать
плачут 	 плакать
слезами 	 слеза
любви 	 любовь
нам 	 мы
русским 	 русский
дураки 	 дурак
Париже 	 париж
сидят 	 сидеть
каменными 	 каменный
болванами 	 болван
Сердечно 	 сердечно
Ваш 	 ваш
Д 	 далее
20/7 	 20/7
октября 	 октябрь
Были 	 быть
вчера 	 вчера
Мережковских 	 мережковский
Оба 	 оба
сияют 	 сиять
довольны 	 довольный
денег 	 деньга
привезли 	 привезти
ожидали 	 ожидать
Ордена 	 орден
красивые 	 красивый
повторял 	 повторять
кроме 	 кроме
одного 	 один
сербского 	 сербский
писателя 	 писатель
про 	 про
Немировича 	 немирович
упомянул 	 упомянуть
Уверяют 	 уверять
правых 	 правый
чувствуется 	 чувствоваться
Россия 	 россия
пил 	 пить
перед 	 перед
представлением 	 представление
королю 	 король
возили 	 возить
баню 	 баня
пьян 	 пьяный
нему 	 он
приставлено 	 приставить
двое 	 двое
молодых 	 молодая
свалили 	 свалить
заявил 	 заявить
свою 	 свой
программу 	 программа
потребовал 	 потребовать
чтоб 	 чтоб
всех 	 весь
сыновей 	 сын
() 	 ()
понял 	 понять
генерал 	 генерал
говорил 	 говорить
социал-демократическое 	 социал-демократический
презрительное 	 презрительный
отношение 	 отношение
ко 	 к
всем 	 весь
писателям 	 писатель
Журнала 	 журнал
пока 	 пока
Лучше 	 хороший
газета 	 газета
достаточно 	 достаточно
Основалось 	 основаться
намечено 	 наметить
выпустить 	 выпустить
12 	 12
книг 	 книга
Рассказывали 	 рассказывать
далеко 	 далеко
лавировали 	 лавировать
Мережковский 	 мережковский
воодушевлен 	 воодушевлённый
религиозным 	 религиозный
настроением 	 настроение
Загреба 	 загреб
Его 	 он
считают 	 считать
чуть 	 чуть
католиком 	 католик
католики 	 католик
работает 	 работать
соединение 	 соединение
церквей 	 церковь
уверены 	 уверить
произойдет 	 произойти
православную 	 православный
сумеют 	 суметь
поработить 	 поработить
Вечером 	 вечером
горюет 	 горевать
такое 	 такой
заглавие 	 заглавие
назвать 	 назвать
истока 	 исток
Толстой-душенька 	 толстой-душенька
написал 	 написать
Детство 	 детство
Отрочество 	 отрочество
Юность 	 юность
запнулся 	 запнуться
17 	 17
трех 	 три
книгах 	 книга
40 	 40
должен 	 должный
написать 	 написать
крайнем 	 крайний
двух 	 два
одно 	 один
либо 	 либо
кратче 	 краткий
сколько 	 сколько
выйдет 	 выйти
томов 	 том
денно 	 денно
нощно 	 нощно
Иногда 	 иногда
оставить 	 оставить
заняться 	 заняться
другим 	 другой
27/14окт 	 27/14окт
Сутки 	 сутки
дождь 	 дождь
ни 	 ни
минуту 	 минута
переставая 	 переставать
вода 	 вод
Гул 	 гул
ручья 	 ручей
вдоль 	 вдоль
Mont 	 mont
Fleury 	 fleury
Ночью 	 ночью
гром 	 гром
Галина 	 галина
видала 	 видалый
танцуют 	 танцевать
кадриль 	 кадриль
Чтобы 	 чтобы
размяться 	 размяться
позвали 	 позвать
Капитана9 	 капитана9
стали 	 стать
танцовать 	 танцовать
забыла 	 забыть
четвертую 	 четвертовать
фигуру 	 фигура
кадрили 	 кадриль
относятся 	 относиться
лансье 	 лансье
читал 	 читать
Мопассана 	 мопассан
работала 	 работать
24/11 	 24/11
Шесть 	 шесть
венчались 	 венчаться
этот 	 этот
Была 	 быть
одна 	 один
письма 	 письмо
котором 	 который
пишет 	 писать
Вы 	 вы
плотно 	 плотно
покинули 	 покинуть
обречена 	 обречь
любовь 	 любовь
верную 	 верный
неразделенную 	 неразделенный
со 	 с
мной 	 я
милы 	 милый
хорошем 	 хороший
настроении 	 настроение
доволен 	 довольный
тяжелом 	 тяжёлый
ей 	 она
негде 	 негде
Возр. 	 возр.
редактируют 	 редактировать
даже 	 даже
отд 	 отд
изд 	 изд
Поднимается 	 подниматься
взять 	 взять
нарушить 	 нарушить
контракт 	 контракт
говорила 	 говорить
единственный 	 единственный
подражать 	 подражать
людям 	 человек
относится 	 относиться
части 	 часть
мира 	 мир
любит 	 любить
дружить 	 дружить
Кульманами 	 кульман
д 	 далее
Человек 	 человек
б 	 б
переписывались 	 переписываться
Т 	 том
Манухиной 	 манухина
писателях 	 писатель
них 	 они
форма 	 форма
уменье 	 умение
нечего 	 нечего
сказать 	 сказать
дек./19 	 дек./19
нояб 	 ноябнуть
Телефон 	 телефон
Екат[ерина 	 екат[ерин
Павловна 	 павло
Пешкова 	 пешков
захватывает 	 захватывать
дыхание 	 дыхание
Ницце 	 ницца
можете 	 мочь
приехать 	 приехать
повидаться 	 повидаться
Грасса 	 грасс
прямого 	 прямой
сообщения 	 сообщение
Нужно 	 нужно
ехать 	 ехать
через 	 через
Канн 	 канна
приедем 	 приехать
Хорошо 	 хорошо
ждать 	 ждать
вас 	 вы
решетки 	 решётка
входе 	 вход
вокзала 	 вокзал
Буду 	 быть
вязаном 	 вязаный
пальто 	 пальто
узнаете 	 узнать
Поехала 	 поехать
незаметно 	 незаметно
провела 	 провести
прихода 	 приход
поезда 	 поезд
Ниццы 	 ницца
30 	 30
м 	 метр
Уже 	 уже
прошла 	 пройти
вся 	 весь
публика 	 публика
Их 	 они
Жду 	 ждать
Сердце 	 сердце
бьется 	 биться
Ек 	 ек
П 	 плата
последней 	 последний
кого 	 кто
видела 	 видеть
нашего 	 наш
отъезда 	 отъезд
юг 	 юг
мае 	 май
1918 	 1918
первую 	 один
должна 	 должный
увидеть 	 увидеть
оттуда 	 оттуда
Наконец 	 наконец
вижу 	 видеть
дама 	 дама
чем-то 	 что-то
напомнившая 	 напомнить
Савинкову 	 савинкова
довольно 	 довольно
весело 	 весело
машет 	 махать
Екатерина 	 екатерина
поцеловались 	 поцеловаться
поздоровалась 	 поздороваться
Брежневым 	 брежнев
Зашли 	 заслать
Consigne 	 consigne
Сдали 	 сдать
кожаный 	 кожаный
чемодан 	 чемодан
беличье 	 беличий
(очень 	 (очень
красивой 	 красивый
темной 	 тёмный
белки) 	 белки)
Куда 	 куда
идти 	 идти
повела 	 повести
англичанам 	 англичанин
Заперто 	 запереть
Пошли 	 послать
сели 	 сесть
глубине 	 глубина
кафе 	 кафе
спросили 	 спросить
St 	 st
Raphael 	 raphael
Сначала 	 сначала
родных 	 родные
Мать 	 мать
жива 	 живой
80 	 80
Жена 	 жена
Максима 	 максим
Россию 	 россия
Максим 	 максим
ничего 	 ничто
делает 	 делать
марки 	 марка
перестал 	 перестать
собирать 	 собирать
Говорила 	 говорить
Мите10 	 мите10
болезни 	 болезнь
обещала 	 обещать
спросила 	 спросить
достать 	 достать
наших 	 наш
наши 	 наш
дневники 	 дневник
старые 	 старое
вещи 	 вещий
сказала 	 сказать
кое 	 кой
провезти 	 провезти
раньше 	 ранний
Горький 	 горький
мог 	 мочь
угодно 	 угодный
вывезти 	 вывезти
багаж 	 багаж
осматривали 	 осматривать
Малиновской 	 малиновский
видалась 	 видаться
занимала 	 занимать
высшие 	 высокий
посты 	 пост
Толстыми 	 толстой
видается 	 видаться
слишком 	 слишком
много 	 много
дружит 	 дружить
большевиками 	 большевик
покупал 	 покупать
дешево 	 дёшево
мебель 	 мебель
пьеса 	 пьеса
Императрица... 	 императрица...
Умер 	 умереть
Крандиевский 	 крандиевский
сама 	 сам
по-прежнему 	 по-прежнему
глуха 	 глухой
Скирмунт 	 скирмунт
живет 	 жить
пропадал 	 пропадать
Было 	 быть
устроила 	 устроить
визу 	 виза
снова 	 снова
таким 	 такой
каким 	 какой
заграницы 	 заграницы
Вообще 	 вообще
видаюсь 	 видаться
одним 	 один
Дзержинским 	 дзержинский
считаю 	 считать
порядочным 	 порядочный
человеком 	 человек
считал 	 считать
раз 	 раз
находится 	 находиться
правительстве 	 правительство
которое 	 который
признает 	 признать
расстрелы 	 расстрел
уклоняться 	 уклоняться
каких 	 какой
мест 	 место
всего 	 всего
ГПУ 	 гпу
которым 	 который
говорить 	 говорить
Когда 	 когда
Кр 	 кр
решила 	 решить
обращаться 	 обращаться
однажды 	 однажды
надо 	 надо
спасти 	 спасти
обратиться 	 обратиться
Дзержинскому 	 дзержинский
удивлена 	 удивить
выслушал 	 выслушать
вникал 	 вникать
каждый 	 каждый
случай 	 случай
знакомых 	 знакомый
Соловках11 	 соловках11
Она 	 она
Соловках 	 соловка
Переменили 	 переменить
администрацию 	 администрация
неразборчиво 	 неразборчивый
написанное 	 написать
слово 	 слово
тот 	 тот
администрации 	 администрация
спрашивала 	 спрашивать
страшный 	 страшный
страшного 	 страшный
примет 	 принять
всякую 	 всякий
большевицкой 	 большевицкий
выразила 	 выразить
сожаление 	 сожаление
России 	 россия
переносит 	 переносить
кошек 	 кошка
Одессе 	 одесса
ощутили 	 ощутить
всей 	 весь
кожей 	 кожа
заболел 	 заболеть
вида 	 вид
стала 	 стать
расспрашивать 	 расспрашивать
писал 	 писать
такие 	 такой
злобные 	 злобный
злоба 	 злоба
пафос 	 пафос
белые 	 белые
изменим 	 изменить
пал 	 пасть
борьбе 	 борьба
То 	 то
ведь 	 ведь
Каляева 	 каляев
отрекались 	 отрекаться
выше 	 выше
Нет 	 нет
поезд 	 поезд
тронулся 	 тронуться
Меня 	 я
охватило 	 охватить
грустное 	 грустный
наше 	 наш
свидание 	 свидание
длилось 	 длиться
рада 	 рада
Теперь 	 теперь
переменилась 	 перемениться
способна 	 способный
дурное 	 дурной
сознательно 	 сознательно
живя 	 живить
нужнике 	 нужник
многому 	 многое
принюхаешься 	 принюхаться
самой 	 самый
появилось 	 появиться
спокойствие 	 спокойствие
пополнела 	 пополнеть
глаза 	 глаз
уменьшились 	 уменьшиться
менее 	 менее
красивы 	 красивый
молодое 	 молодой
Работает 	 работать
даром 	 даром
Получает 	 получать
Горького 	 горький
100 	 100
рубл 	 рубла
руб 	 рубль
мать 	 мать
Скупо 	 скупо
дает 	 давать
Мак 	 мак
Голос 	 голос
флюиды 	 флюид
приятные 	 приятный
стоя 	 стоя
платформе 	 платформа
надеялась 	 надеяться
вами 	 вы
почувствовала 	 почувствовать
люблю 	 любить
боялся 	 бояться
скомпрометировать 	 скомпрометировать
Где 	 где
остановиться 	 остановиться
Могут 	 мочь
неприятности 	 неприятность
центре 	 центр
Пасси 	 пасся
центр 	 центр
дек./24 	 дек./24
ноября 	 ноябрь
тревожно 	 тревожный
Беспокоит 	 беспокоить
будущее 	 будущее
проживем 	 прожить
издательстве 	 издательство
Что 	 что
послать 	 послать
Избранные 	 избранный
рассказы 	 рассказ
Окаянные 	 окаянный
дни 	 день
Книжку 	 книжка
рассказов 	 рассказ
вечер 	 вечер
надежды 	 надежда
продавать 	 продавать
билеты 	 билет
тон 	 тон
голоса 	 голос
что-либо 	 что-либо
подсознательно 	 подсознательно
хотела 	 хотеть
оправдаться 	 оправдаться
мой 	 мой
слух 	 слух
обманешь 	 обмануть
интонация 	 интонация
выдает 	 выдавать
Потрясены 	 потрясти
смертью 	 смерть
Юл 	 юла
Айхенвальда12 	 айхенвальда12
прочел 	 прочесть
упал 	 упасть
спину 	 спин
выражение 	 выражение
глаз 	 глаз
известии 	 известие
смерти 	 смерть
Юлия 	 юлий
обедом 	 обед
грустно-расстроенный 	 грустно-расстроить
молчал 	 молчать
Целый 	 целый
мелькают 	 мелькать
голове 	 голов
встреч 	 встреча
Вспоминается 	 вспоминаться
ехали 	 ехать
Киева 	 киев
Москву 	 москва
часами 	 часами
просиживали 	 просиживать
вагоне-ресторане 	 вагон-ресторан
споря 	 спорить
женщине 	 женщина
назначение 	 назначение
женой 	 жена
матерью 	 матерь
курсы 	 курс
лукавого 	 лукавый
Назначение 	 назначение
страдать 	 страдать
матери 	 матерь
знаменитое 	 знаменитый
собрание 	 собрание
завтрак 	 завтрак
персон 	 персона
Гукасовым 	 гукасов
неистовствовал 	 неистовствовать
кричал 	 кричать
кружковщине 	 кружковщина
неуважении 	 неуважение
писательскому 	 писательский
званию 	 звание
Всем 	 весь
неловко 	 неловко
Ни 	 ни
Яблоновский 	 яблоновский
поддержали 	 поддержать
пробормотал 	 пробормотать
что-то 	 что-то
несвязное 	 несвязный
Куполе 	 купол
Исаакия 	 исаакий
общем 	 общий
неудачным 	 неудачный
(передаю 	 (передавать
слов 	 слово
Маковского) 	 маковского)
Гукасову 	 гукасова
открыты 	 открытый
карты 	 карта
которых 	 который
знать 	 знать
этим 	 это
закрепилась 	 закрепиться
кабала 	 кабала
Концерт 	 концерт
пользу 	 польза
журналистов 	 журналист
провалился 	 провалиться
копейки 	 копейка
вызвал 	 вызвать
прошений 	 прошение
10/23 	 10/23
письмо 	 письмо
Фондаминского 	 фондаминский
интересное 	 интересный
начинание 	 начинание
издавать 	 издавать
биографии-романы 	 биография-романа
Предлагают 	 предлагать
Яну 	 ян
Пока 	 пока
согласились 	 согласиться
Декабристы 	 декабрист
Пушкин 	 пушкин
Тургенев 	 тургенев
предлагали 	 предлагать
Толстого 	 толстой
Чехова 	 чехов
Лермонтова13 	 лермонтова13
Вере 	 вера
Николаевне 	 николай
передайте 	 передать
фельетон14 	 фельетон14
имел 	 иметь
успех 	 успех
хвалят 	 хвалить
скрою 	 скроить
Только 	 только
страх 	 страх
Верное 	 верный
чутье 	 чутьё
нашему 	 наш
книгоиздательству 	 книгоиздательство
предлагала 	 предлагать
выпускать 	 выпускать
художественные 	 художественный
биографии 	 биография
Никто 	 никто
отнесся 	 отнестись
моему 	 мой
проекту 	 проект
14/27 	 14/27
декабря 	 декабрь
Пришла 	 пришлый
Зурова 	 зуров
Отчина 	 отчин
историческое 	 исторический
описание 	 описание
Псково-Печерского 	 псково-печерский
монастыря 	 монастырь
весной 	 весной
работал 	 работать
монастырской 	 монастырский
библиотеке 	 библиотека
сделал 	 сделать
зарисовки 	 зарисовка
букв 	 буква
концовок 	 концовка
водяных 	 водяной
знаков 	 знак
кожаных 	 кожаный
тиснений 	 тиснение
обнаружил 	 обнаружить
заброшенную 	 забросить
икону 	 икона
рисунками 	 рисунок
обители 	 обитель
конца 	 конец
царствования 	 царствование
Михайловича 	 михайло
богатую 	 богатый
киноварными 	 киноварный
буквами 	 буква
рукописную 	 рукописный
XVII 	 xvii
века 	 век
государева 	 государев
дьяка 	 дьяк
Мисюря 	 мисюрить
Мунейхина 	 мунейхина
Названа 	 назвать
книга 	 книга
Написана 	 написать
просто 	 просто
сжато 	 сжато
древними 	 древние
словами 	 слово
Молодец 	 молодец
серьезные 	 серьёзный
задания 	 задание
религиозен 	 религиозный
письме 	 письмо
сообщил 	 сообщить
добровольцем 	 доброволец
Праге 	 прага
(Г[алина 	 (г[алин
вспомнила 	 вспомнить
его) 	 его)
посоветовал 	 посоветовать
уехать 	 уехать
из-за 	 из-за
здоровья 	 здоровье
ранен 	 раненый
Перезвонах15 	 перезвонах15
секретарем 	 секретарь
Прислал 	 прислать
крохотную 	 крохотный
фотографию 	 фотография
Лицо 	 лицо
приятное 	 приятный
самолюбивый 	 самолюбивый
характером 	 характер
написала 	 написать
письмо16 	 письмо16
Анна 	 анна
хороша 	 хороший
Смешно 	 смешно
такую 	 такой
жару 	 жара
вьюгу 	 вьюга
мороз 	 мороз
Интересная 	 интересный
черта 	 черта
зимних 	 зимний
Капри 	 капереть
Цейлоне 	 цейлон
Глотове 	 глотов
зимой 	 зимой
стужу 	 стужа
гуляли 	 гулять
Галей 	 галей
Валлье 	 валлье
Рощине 	 рощин
жалели 	 жалеть
многого 	 многое
понимает 	 понимать
едва 	 едва
совершенствоваться 	 совершенствоваться
повесть 	 повесть
17-18 	 17-18
годов 	 год
вклеена 	 вклеить
фотография 	 фотография
Ю 	 ю
Айхенвальда 	 айхенвальд
вырезанная 	 вырезать
газеты 	 газета
гостях 	 гость
Татаринова 	 татаринов
находился 	 находиться
подавленном 	 подавить
мрачном 	 мрачный
Говорил 	 говорить
надежд 	 надежда
стоит 	 стоить
Вышел 	 выйти
бульваре 	 бульвар
трамвай 	 трамвай
аллеей 	 аллея
близорукости 	 близорукость
попал 	 попасть
под 	 под
вагон 	 вагон
Трамвай 	 трамвай
придавил 	 придавить
пришлось 	 прийтись
поднимать 	 поднимать
специальным 	 специальный
краном 	 кран
подъемником 	 подъёмник
видимо 	 видимо
оказался 	 оказаться
бессознательном 	 бессознательный
состоянии 	 состояние
Изуродован 	 изуродовать
выбиты 	 выбить
зубы 	 зуб
больнице 	 больница
брат 	 брат
Вышеславцевой 	 вышеславцев
видел 	 видеть
пришел 	 прийти
многие 	 многие
Берлине 	 берлин
любили 	 любить
Милюков 	 милюков
возражал 	 возражать
Зайцеву 	 зайцев
Союза 	 союз
конфессиональное 	 конфессиональный
учреждение 	 учреждение
Поддержал 	 поддержать
Аминад 	 аминад
Дон-Аминадо 	 донаука-аминадо
Панихида 	 панихида
народу 	 народ
большинство 	 большинство
евреи 	 еврей
29/16 	 29/16
Мне 	 я
Оли 	 оля
Иловайской17 	 иловайской17
старом 	 старый
Пимене 	 пимен
помнит 	 помнить
далека 	 далёкий
литературы 	 литература
нужно18 	 нужно18
Тяжело 	 тяжело
бездетным 	 бездетный
женщинам 	 женщина
невыносимо 	 невыносимый
Умрешь 	 умереть
никого 	 никто
оставишь 	 оставить
некому 	 некого
тебя 	 ты
оплакивать 	 оплакивать
молиться 	 молиться
Верно 	 верно
мудрый 	 мудрый
народ 	 народ
считали 	 считать
бездетность 	 бездетность
наказание 	 наказание
грехи 	 грех
Так 	 так
оно 	 оно
Поняла 	 понять
поздно 	 поздно
Проснулась 	 проснуться
рано 	 рано
Слышу 	 слышать
встал 	 встать
одеваться 	 одеваться
вошел 	 войти
готова 	 готовый
ласково 	 ласково
поздоровался 	 поздороваться
признак 	 признак
хороший 	 хороший
власти 	 власть
работы 	 работа
Каннах 	 канна
приятно 	 приятно
какой-то 	 какой-то
давно 	 давно
прошедший 	 пройти
Купила 	 купить
дневничек 	 дневничек
французский 	 французский
черном 	 чёрный
мягком 	 мягкий
переплете 	 переплёт
Послали 	 послать
Галининой 	 галинина
бабушке 	 бабушка
подстригся 	 подстричься
парикмахеру 	 парикмахер
сэкономила 	 сэкономить
Пили 	 пить
англичан 	 англичанин
купили 	 купить
Галине 	 галина
конфет 	 конфета
Возвращались 	 возвращаться
классе 	 класс
неожиданно 	 неожиданно
поцеловал 	 поцеловать
Н. 	 н.
Эртеле 	 эртело
написать19 	 написать19
1929 	 1929
дневничке 	 дневничек
(новый 	 (новый
стиль) 	 стиль)
Зачем 	 зачем
писатель 	 писатель
зачеркивает 	 зачёркивать
Затем 	 затем
уничтожить 	 уничтожить
потом 	 потом
веяние 	 веяние
Гофмана 	 гофман
Щеголева 	 щеголев
стараются 	 стараться
восстановить 	 восстановить
варианты 	 вариант
От 	 от
повеситься 	 повеситься
Достоевский 	 достоевский
гениальностью 	 гениальность
социалистов 	 социалист
этих 	 этот
Шигалевых 	 шигалевый
Толстой 	 толстой
думал 	 думать
проник 	 проникнуть
самых 	 самый
глубин 	 глубина
работах 	 работа
Овсянико-Куликовском 	 овсянико-куликовский
Рассказала 	 рассказать
плане 	 план
одобрил 	 одобрить
Открытка 	 открытка
Кульман 	 кульман
Журнал 	 журнал
интриг 	 интрига
зарежет 	 зарезать
позвал 	 позвать
скончался 	 скончаться
Николай 	 николай
Николаевич1 	 николаевич1
огорчен 	 огорчить
печален 	 печальный
Думал 	 думать
тому 	 тот
Орловском 	 орловский
вокзале 	 вокзал
ходил 	 ходить
вез 	 везти
прах 	 прах
отца 	 отец
блестящ 	 блестящий
молод 	 молодой
рыжеватыми 	 рыжеватый
кудрявящимися 	 кудрявиться
волосами 	 волос
столкнутся 	 столкнуться
поклонюсь 	 поклониться
праху 	 прах
Антибах 	 антибах
Решили 	 решить
Антиб 	 антиб
прошлая 	 прошлый
умер 	 умереть
ибо 	 ибо
горестей 	 горесть
лучшее 	 хороший
погибло 	 погибнуть
войне 	 война
общей 	 общий
гражданской 	 гражданский
рядах 	 ряд
худшие 	 плохой
7 	 7
Наше 	 наш
Рождество 	 рождество
День 	 день
холодно 	 холодный
Едем 	 ехать
панихиду 	 панихида
Николае 	 николай
Николаевиче 	 николай
Подъехали 	 подъехать
вилле 	 вилла
Тенар 	 тенар
автомобиле 	 автомобиль
около 	 около
Белый 	 белый
двора 	 двор
широкого 	 широкий
поместья 	 поместье
офицер 	 офицер
форме 	 форма
Входим 	 входить
нечто 	 нечто
вестибюля 	 вестибюль
толпится 	 толпиться
Проходим 	 проходить
залу 	 зал
гробу 	 гроб
лежит 	 лежать
Комната 	 комната
высокая 	 высокий
окна 	 окно
дверь 	 дверь
завешены 	 завесить
красного 	 красный
тона 	 тон
плюшевыми 	 плюшевый
драпри 	 драпри
щели 	 щель
пробивается 	 пробиваться
солнце 	 солнце
дубовый 	 дубовый
глубокий 	 глубокий
такого 	 такой
низких 	 низкий
подставках 	 подставка
необычно 	 необычно
Николаевич 	 николай
черкеске 	 черкеска
высок 	 высокий
худым 	 худой
пропала 	 пропасть
грудь 	 грудь
Поразила 	 поразить
правая 	 правый
рука 	 рука
вышедшая 	 выйти
рукава 	 рукав
крепко 	 крепко
держит 	 держать
резной 	 резной
черный 	 чёрный
крест 	 крест
Почетный 	 почётный
караул 	 караул
обе 	 оба
стороны 	 сторона
гроба 	 гроб
сменился 	 смениться
казаки 	 казак
высокие 	 высокий
стройные 	 стройный
своих 	 свой
черкесках 	 черкеска
Тишина 	 тишина
Простота 	 простота
Молодой 	 молодая
визитке 	 визитка
Псалтырь 	 псалтырь
подъезжала 	 подъезжать
волновалась 	 волноваться
мысли 	 мысль
величии 	 величие
прийти 	 прийти
поклониться 	 поклониться
покойнику 	 покойник
вошли 	 войти
волнение 	 волнение
усилилось 	 усилиться
соединении 	 соединение
серьезностью 	 серьёзность
почетного 	 почётный
караула 	 караул
немногих 	 немногий
присутствующих 	 присутствующий
Около 	 около
стены 	 стена
огромный 	 огромный
венок 	 венка
прислоненный 	 прислонить
крышке 	 крышка
которой 	 который
прибита 	 прибить
металлическая 	 металлический
доска 	 доска
надписью 	 надпись
Nicolas 	 nicolas
Nicolaevitch 	 nicolaevitch
сочли 	 счесть
фамилию 	 фамилия
начертали 	 начертать
крупнее 	 крупный
изголовьем 	 изголовье
столик 	 столик
покрытый 	 покрыть
белой 	 бела
салфеткой 	 салфетка
образами 	 образ
Панихиды 	 панихида
ждали 	 ждать
часу 	 час
волновался 	 волноваться
сильно 	 сильно
пришли 	 прислать
сменили 	 сменить
ручьем 	 ручьем
щеке 	 щека
текли 	 течь
слезы 	 слеза
хороним 	 хоронить
прежнюю 	 прежний
живешь 	 жить
зажило 	 зажить
наткнешься 	 наткнуться
что-нибудь 	 что-нибудь
оказывается 	 оказываться
обнажена 	 обнажить
больно 	 больно
панихиде 	 панихида
вышли 	 выйти
Петр 	 пётр
супругой 	 супруга
дети 	 ребёнок
глубоком 	 глубокий
трауре 	 траур
Каннский 	 каннский
батюшка 	 батюшка
Пел 	 петь
казачий 	 казачий
хор 	 хор
родственники 	 родственник
подошли 	 подойти
первыми 	 один
Милица 	 милица
Опустились 	 опуститься
колени 	 колено
помолились 	 помолиться
поцеловали 	 поцеловать
руку 	 рука
георгиевский 	 георгиевский
племянники 	 племянник
пасынок 	 пасынок
падчерица 	 падчерица
остальные 	 остальной
Наши 	 наш
прощалась 	 прощаться
Вблизи 	 вблизи
поразило 	 поразить
маленьким 	 маленькая
похожим 	 похожий
портреты 	 портрет
Запаха 	 запах
чувствовалось 	 чувствоваться
принесли 	 принести
венков 	 венок
трогательные 	 трогательный
пучки 	 пучок
белая 	 белый
гвоздика 	 гвоздик
например 	 например
низко 	 низко
поклонились 	 поклониться
отбыли 	 отбыть
внутренние 	 внутренний
покои 	 покой
похож 	 похожий
Николая 	 николай
Николаевича 	 николай
взволнован 	 взволновать
вынимал 	 вынимать
носовой 	 носов
платок 	 платок
ворота 	 ворот
розовые 	 розовый
снега 	 снег
горах 	 гора
поразили 	 поразить
красотой 	 красота
изумительно 	 изумительно
прекрасный 	 прекрасный
отправились 	 отправиться
пешком 	 пешком
площади 	 площадь
автобусы 	 автобус
Сели 	 сесть
русских2 	 русских2
обещал 	 обещать
тоскливым 	 тоскливый
нудным 	 нудный
Георгий 	 георгий
Иванов3 	 иванов3
Приходу 	 приход
рады 	 рад
видали 	 видать
уезжают 	 уезжать
Жили 	 жить
Винтерфельда 	 винтерфельд
Будто 	 будто
Одоевцевой 	 одоевцев
плеврит 	 плеврит
Поболтать 	 поболтать
роман 	 роман
завидует 	 завидовать
нашей 	 наш
нигде 	 нигде
Едва 	 едва
выжила 	 выжить
Бретани 	 бретань
Ходасевиче 	 ходасевич
умен 	 умный
известной 	 известный
высоты 	 высота
зато 	 зато
Чехи 	 чех
прекратили 	 прекратить
пособия 	 пособие
минус 	 минус
380 	 380
французах 	 француз
известно 	 известно
Зеленой 	 зелёный
Лампе 	 лампа
читала 	 читать
эмиграции 	 эмиграция
Смерть 	 смерть
выбила 	 выбить
рабочей 	 рабочий
колеи 	 колея
будем 	 быть
бросил 	 бросить
вспомнил 	 вспомнить
Эртеля 	 эртеля
отправился 	 отправиться
анатомический 	 анатомический
театр 	 театр
груды 	 груда
кусков 	 кусок
тела 	 тело
трупы 	 труп
уничтожили 	 уничтожить
Долго 	 долго
оценен 	 оценить
ездить 	 ездить
До 	 до
сих 	 сей
пор 	 пора
успокоиться 	 успокоиться
художественное 	 художественный
более 	 более
хрупко 	 хрупко
самое 	 самый
тончайшее 	 тонкий
стекло 	 стекло
Подсчитали 	 подсчитать
Бискру 	 бискра
хватит 	 хватить
Решено 	 решить
ночевка 	 ночёвка
Марселе 	 марсел
Дижон 	 дижон
понравится 	 понравиться
пожалуй 	 пожалуй
глупо 	 глупо
Эртеле4 	 эртеле4
Пришли 	 прислать
2000 	 2000
Новостей 	 новость
3000 	 3000
французов 	 француз
спал 	 спасть
Подсчитал 	 подсчитать
без 	 без
прав 	 право
Амфитеатрова5 	 амфитеатрова5
полученного 	 получить
Знаете 	 знаете
мудрено 	 мудрено
выразить 	 выразить
мое 	 мой
восхищение 	 восхищение
этою 	 этой
Вашей 	 ваш
вещью 	 вещь
растет 	 расти
книги 	 книга
Недавно 	 недавно
итальянской 	 итальянский
лекции 	 лекция
русской 	 русский
вырастет 	 вырасти
Гёте 	 гуть
покуда 	 покуда
Фауста 	 фауст
однако 	 однако
вероятности 	 вероятность
3-ей 	 3-она
слова 	 слово
мои 	 мой
подтверждаются 	 подтверждаться
телеграмму 	 телеграмма
Нилусу 	 нилус
18-ого 	 18-ого
берем 	 брать
квартиру 	 квартира
кофий 	 кофий
Марсель 	 марсель
Доехали 	 доехать
старого 	 старое
порта 	 порт
темно 	 темно
волшебного 	 волшебный
впечатления 	 впечатление
месячную 	 месячный
Будет 	 быть
стоить 	 стоить
столько 	 столько
дешевле 	 дешёвый
ночью 	 ночью
устанем 	 устать
меньше 	 маленький
крушение 	 крушение
главной 	 главный
магистрали 	 магистраль
Валенса 	 валенса
окружным 	 окружный
путем 	 путём
приехали 	 приехать
Взяли 	 взять
вразброд 	 вразброд
25 	 25
Выпили 	 выпить
вина 	 вино
чувствовала 	 чувствовать
завтрак-коробку 	 завтрак-коробка
хватило 	 хватить
Ехать 	 ехать
часа 	 час
ездили 	 ездить
нашли 	 найти
комнаты 	 комната
International 	 international
любезен 	 любезный
пессимистичен 	 пессимистичный
Завтракал 	 завтракать
Деникиным 	 деникин
уехал 	 уехать
Капбретона 	 капбретон
Бальмонта 	 бальмонт
вечные 	 вечный
скандалы 	 скандал
требование 	 требование
пива 	 пиво
ночи 	 ночь
воды 	 вода
Бальмонту 	 бальмонт
Поэту 	 поэт
Стыдно 	 стыдно
французами 	 француз
Завтракали 	 завтракать
Встретили 	 встретить
по-родственному 	 по-родственному
тиха 	 тихий
печальна 	 печальный
всяких 	 всякий
неприятностей 	 неприятность
Переезжаем 	 переезжать
рю 	 рю
дю 	 дю
Бош 	 бош
жили 	 жить
Михайловы 	 михайлов
Берем 	 брать
10 	 10
евразийцев6 	 евразийцев6
Кое-что 	 кое-что
узнала 	 узнать
нового 	 новое
Евразийцы 	 евразиец
Всем[ирную 	 всем[ирный
Церковь 	 церковь
Федорова7 	 федорова7
философа 	 философ
библиотекаря 	 библиотекарь
Румянцевского 	 румянцевский
музея 	 музей
(с 	 (с
переписывался 	 переписываться
Эртель) 	 эртель)
Ильин8 	 ильин8
отбивал 	 отбивать
нападения 	 нападение
евр[азийцы 	 евр[азиец
близки 	 близкий
духу 	 дух
большевикам 	 большевик
Эта 	 этот
близость 	 близость
веревка 	 верёвка
шее 	 шея
удавившегося 	 удавиться
славянофилов 	 славянофил
прежде 	 прежде
свободны 	 свободный
Христос 	 христос
принес 	 принести
свободу 	 свобода
Первым 	 один
Федотов9 	 федотов9
Вышеславцев10 	 вышеславцев10
танцуя 	 танцевать
остроумно 	 остроумно
марксистской 	 марксистский
философии 	 философия
элементарной 	 элементарный
Анну 	 анна
кончила 	 кончить
предпоследней 	 предпоследний
главе 	 глава
уехали 	 уехать
13 	 13
расспрашивали 	 расспрашивать
Арс. 	 арс.
кратко 	 кратко
видит 	 видеть
переживает 	 переживать
войну 	 война
приходит 	 приходить
тянется 	 тянуться
небу 	 небо
Предложение 	 предложение
вместо 	 вместо
постричь 	 постричь
миновала 	 миновать
чаша 	 чаша
счастлива 	 счастливый
довольна 	 довольный
Мотив 	 мотив
сберечь 	 сберечь
общее 	 общий
печальное 	 печальный
поняла 	 понять
никому 	 никто
приезд 	 приезд
доставил 	 доставить
Пожалуй 	 пожалуй
пора 	 пора
уйти 	 уйти
сень 	 сеня
струй 	 струя
Портит 	 портить
предстоящий 	 предстоящий
Напрасно 	 напрасно
пожили 	 пожить
Меньше 	 маленький
истратили 	 истратить
нервы 	 нерв
покойнее 	 покойный
Похудел 	 похуделый
Стал 	 стать
тише 	 тиша
спокойных 	 спокойный
тонах 	 тон
Устроил 	 устроить
радио 	 радио
восхищается 	 восхищаться
Рассказывал 	 рассказывать
Гукасова 	 гукасова
громил 	 громить
панораму 	 панорама
Маковский 	 маковский
хотел 	 хотеть
печатать 	 печатать
позволяет 	 позволять
редакторская 	 редакторский
совесть 	 совесть
давать 	 давать
мрак 	 мрак
читателям 	 читатель
Хвалил 	 хвалить
восхищался 	 восхищаться
стихами 	 стих
кукушка 	 кукушка
хвалит 	 хвалить
петуха 	 петух
кукушку 	 кукушка
Бальмонты 	 бальмонт
Бордо 	 бордо
Вернулись 	 вернуться
Шмелевых 	 шмелев
радушно 	 радушно
угостили 	 угостить
увлечен 	 увлечь
слушали 	 слушать
вечерню 	 вечерня
Лондона 	 лондон
завести 	 завести
пороли 	 пороть
веник 	 веник
превращался 	 превращаться
мелкие 	 мелкий
кусочки 	 кусочек
отце 	 отец
бесконечно 	 бесконечно
22 	 22
Приходил 	 приходить
прощаться 	 прощаться
Илюша 	 илюша
Едет 	 ехать
радостью 	 радость
Бельведер 	 бельведер
Лоллий 	 лоллия
Львов 	 львов
говорящей 	 говорящий
фильмы11 	 фильмы11
Любопытное 	 любопытный
изобретение 	 изобретение
вытесняется 	 вытесняться
машиной 	 машина
Готовлю 	 готовить
обед 	 обед
Рощин 	 рощин
Забегал 	 забегать
Нилус 	 нилус
желтая 	 жёлтый
повестка 	 повестка
заплатят 	 заплатить
полудня 	 полдень
придут 	 прийти
покормила 	 покормить
дать 	 дать
могла 	 мочь
самих 	 сам
долги 	 долг
Сказала 	 сказать
обедать 	 обедать
воскресенье 	 воскресение
марта 	 март
Берберова 	 берберов
зеленом 	 зелёный
проста 	 простой
решительна 	 решительный
беспощадна 	 беспощадный
вздумал 	 вздумать
читать 	 читать
слушая 	 слушать
домой 	 домой
выслушав 	 выслушать
Пойдем 	 пойти
увела 	 увести
тихо 	 тихо
сконфузясь 	 сконфузиться
олицетворение 	 олицетворение
беспощадности 	 беспощадность
молодости 	 молодость
разрывается 	 разрываться
жалости 	 жалость
многолюдно 	 многолюдно
моя 	 мой
болезнь 	 болезнь
драло 	 драть
горло 	 горло
тех 	 тот
кем 	 кто
начинали 	 начинать
эмиграцию 	 эмиграция
постарели 	 постареть
сравнивал 	 сравнивать
Зарубежным 	 зарубежный
съездом12 	 съездом12
удачным 	 удачный
съезд 	 съезд
1926 	 1926
демократии 	 демократия
поистине 	 поистине
бог 	 бог
бестактности 	 бестактность
Ельяшевич 	 ельяш
Гуляла 	 гулять
Елисейским 	 елисейский
полям 	 поль
Ф 	 ф
презирает 	 презирать
изменяла 	 изменять
мужу 	 муж
искушений 	 искушение
представляются 	 представляться
искусители 	 искуситель
Степуны 	 степуна
обедали 	 обедать
редкое 	 редкий
сочетание 	 сочетание
художником 	 художник
другому 	 другой
мешает 	 мешать
обращении 	 обращение
прост 	 простой
неистощим 	 неистощимый
Наташа 	 наташа
жена 	 жена
прелестна 	 прелестный
куда 	 куда
ценит 	 ценить
Степун 	 степуна
дорога 	 дорога
идеальная 	 идеальный
легко 	 легко
уступит 	 уступить
Зашла 	 зайти
вечером 	 вечером
Адамович 	 адам
готовятся 	 готовиться
лампе 	 лампа
кот 	 кот
понедельник 	 понедельник
Читает 	 читать
Оцуп13 	 оцуп13
Гоголь 	 гоголь
Белинский 	 белинский
незабудки 	 незабудка
тут 	 тут
шутки 	 шутка
неинтересен 	 неинтересный
христианство 	 христианство
почему 	 почему
вместился 	 вместиться
щель 	 щель
церковью 	 церковь
христианством 	 христианство
самый 	 самый
мрачный 	 мрачный
пошел 	 пойти
нигилизм 	 нигилизм
хаос 	 хаос
хочется 	 хотеться
внедрять 	 внедрять
свои 	 свой
идеи 	 идея
Оцупы 	 оцупа
терпятся 	 терпиться
лучших 	 хороший
Удивительная 	 удивительный
свежесть 	 свежесть
чувств 	 чувство
начинают 	 начинать
Атлантиде 	 атлантида
ею 	 она
обрабатывать 	 обрабатывать
молодежь 	 молодёжь
Лекция 	 лекция
Умерен 	 умеренный
изящен 	 изящный
Революцию 	 революция
преступники 	 преступник
фантазеры 	 фантазёр
Результаты 	 результат
положительные 	 положительный
вопреки 	 вопреки
революции 	 революция
революцией 	 революция
настоящей 	 настоящий
большевицкую 	 большевицкий
Прений 	 прение
слышала 	 слышать
праздновать 	 праздновать
десятилетие 	 десятилетие
Сидели 	 сидеть
лампу 	 лампа
заболела 	 заболеть
апреля 	 апрель
Думала 	 думать
Манухина 	 манухина
пришла 	 пришлый
Разговор 	 разговор
Розанове14 	 розанове14
Темный 	 тёмный
лик 	 лик
Розанов 	 розан
по-моему 	 по-моему
возрожденец 	 возрожденец
Христа 	 христос
крестьяне 	 крестьянин
плоть 	 плоть
согласна 	 согласный
начало 	 начать
веком 	 веко
Возрождения 	 возрождение
Волнуюсь 	 волноваться
вечере 	 вечер
продадутся 	 продаться
Впервые 	 впервые
Воскресенье 	 воскресение
первая 	 один
процесс 	 процесс
легких 	 лёгкое
Печень 	 печень
селезенка 	 селезёнка
Содоме 	 содом
Сионе 	 сиона
однополой 	 однополый
занятно 	 занятно
слушать 	 слушать
смотреть 	 смотреть
тихих 	 тихий
мальчиков 	 мальчик
чинно 	 чинно
сидевших 	 сидеть
ряд 	 ряд
Одоевцева 	 одоевцев
Записи 	 запись
возобновляются 	 возобновляться
Илисом 	 илис
Фондаминским 	 фондаминский
разговлялись 	 разговляться
скромно 	 скромно
кухне 	 кухня
подарила 	 подарить
каждому 	 каждый
шоколадному 	 шоколадный
яичку 	 яичко
влитому 	 влитой
скорлупу 	 скорлупа
раскрашенной 	 раскрасить
физиономией 	 физиономия
мыслью 	 мысль
разделенной 	 разделить
драма 	 драма
люди 	 человек
страдают 	 страдать
кабинете 	 кабинет
испытываю 	 испытывать
начинает 	 начинать
нормальной 	 нормальный
жизнью 	 жизнь
Особенно 	 особенно
остро 	 остро
Суэцком 	 суэцкий
канале 	 канал
1910 	 1910
Рождестве 	 рождество
Карташева 	 карташева
(открытка) 	 (открытка)
Пасха 	 пасха
радостная 	 радостный
Кедровы 	 кедровый
вернулись 	 вернуться
Америки 	 америка
вел 	 вести
Пятницу 	 пятница
украсили 	 украсить
нашу 	 наш
заутреню 	 заутреня
пением 	 пение
полно 	 полно
густо 	 густо
по-русски 	 по-русски
красные 	 красный
свечки 	 свечка
колокола 	 колокол
масса 	 масса
богослужебной 	 богослужебный
красоты 	 красота
богослужение 	 богослужение
Всегда 	 всегда
всяком 	 всякий
общении 	 общение
Карташевым 	 карташев
трудно-передаваемое 	 трудно-передаваемый
настоящего 	 настоящий
большого 	 большой
глубоко 	 глубоко
интересно 	 интересно
значительно 	 значительно
самого 	 самый
интересного 	 интересный
коснется 	 коснуться
затронет 	 затронуть
Есть 	 есть
чему 	 что
улыбаться 	 улыбаться
ты 	 ты
знала 	 знать
каком 	 какой
напряжении 	 напряжение
выходит 	 выходить
озаглавил 	 озаглавить
Писать 	 писать
автобиографию 	 автобиография
другое 	 другой
Прав 	 право
неоконченную 	 неоконченный
вещь 	 вещь
успокаивала 	 успокаивать
издал 	 издать
Бог 	 бог
даст 	 дать
успокоился 	 успокоиться
просил 	 просить
принести 	 принести
снизу 	 снизу
оттиски 	 оттиск
Ар. 	 ар.
потерял 	 потерять
надежду 	 надежда
дошел 	 дойти
живых 	 живой
лиц 	 лицо
умерли 	 умереть
ласков 	 ласковый
редкие 	 редкий
минуты 	 минута
Лопатиной 	 лопатин
приезжает 	 приезжать
Мих 	 мих
перешел 	 перейти
католичество 	 католичество
Риме 	 рим
отнеслись 	 отнестись
милостиво 	 милостивый
монастыре 	 монастырь
Папа 	 папа
велел 	 велеть
милостивым 	 милостивый
